마마무 화사, 밀착 브라톱+레깅스…독보적인 건강미	머니투데이
80g 때 버려져 얼마 못 산다던 아깽이에 집사 생기자..'건강미 뿜뿜'	노트펫
"건강미란 이런 것"...김혜연, 건강미 넘치는 화보 공개	뉴스타운
[MHN포토] 마마무 '넘치는 건강미'	문화뉴스
[포토] 화사, '건강미의 표본'	한국경제
[포토] 솔라 '구릿빛 건강미'	일간스포츠
가희, 등산하며 꾸준한 자기관리..건강미 넘치는 미소[★SHOT!]	OSEN
마마무 화사 '건강미 넘치는 레깅스 핏'[엑's HD화보]	엑스포츠뉴스
[포토] 솔라, 건강미 뽐내는 패션	뉴데일리
[포토] 츄, 건강미 넘치는 비율	매일경제
[포토] 화사, '건강미의 표본'	한국경제
[포토] 마마무, 컴백 앞두고 건강미로 예열	시사포커스
[포토] 화사, '건강미 넘치는 그녀~'	한국경제
김혜수, 섹시 건강미의 대명사…마스크 써도 우아함 철철	헤럴드POP
[사진]마마무 화사,'건강미 돋보이는 라인'	OSEN
화사 (마마무) ‘탄탄 몸매에 넘치는 건강미’ [포토엔HD]	뉴스엔
[사진]마마무 화사,'건강미로 완성한 레깅스 핏'	OSEN
비키니 피트니스 (전문), 건강미 넘치는 선수들 무대스케치 (SBS Mr. & Ms Ko...	시민의소리
김혜수, 건강미 넘치는 일상 '시선강탈'	한국일보
김성령, 건강미 넘치는 프리다이빙…"54세 몸매 맞아?"	머니투데이
마이23헬스케어, ‘환불 챌린지프로그램’ 진행	로이슈
오또맘, 건강미 넘치는 모습 '부러워'	뉴스컬처
이하늬, 크롭트 톱 입고 복근 공개…숨길 수 없는 건강미	머니투데이
치어리더 차영현 `건강미 가득` [MK포토]	MK스포츠
김희정, 시선 강탈 구릿빛 섹시..건강미에 감탄	헤럴드POP
[포토] K타이거즈 제로, 건강미 넘치는 퍼포먼스	일간스포츠
'이욱♥'벤, 필라테스 후 건강미 업그레이드..민낯 미모까지 완벽	헤럴드POP
류시원, 재혼 후 근황…49세 나이 믿기지 않는 동안+건강미	한국경제
'눈에 띄는 근육'…치어리더, 남다른 건강미 자랑 [MD화보]	마이데일리
'48.6kg' 김지우, ♥레이먼킴도 놀랄 건강미 가득 보디라인	MBN
‘건강미 대명사’ 최여진, 보트 위 구릿빛 여신 [SNS★컷]	뉴스엔
류화영, 건강미 돋보이는 테니스장에서의 하루	뉴스컬처
‘연애혁명’ 우주소녀 다영, 건강미+걸크러시 가득…스틸컷 공개 [MK★TV컷]	MK스포츠
"지금의 내가 좋다"...안선영, 40대 건강미 빛나는 화보 B컷 대방출	YTN
유이, 피트니스 콘텐츠 구독자 수 10만 돌파..건강미 넘치는 행보	헤럴드POP
[포토] 유현주 '핫함을 더한 건강미'	이데일리
[오마이포토] 'SF9' 재윤, 단단한 건강미	오마이뉴스
매일유업, 박세리‘셀렉스’ CF 촬영 현장서 건강미 발산	조세일보
"168cm·55kg"…안선영, 건강미 넘치는 보디라인 "40대의 미학" [종합]	텐아시아
신현빈, 건강미X고혹미 다 가진 매력부자 '심쿵주의보' [화보]	TV리포트
'견미리 딸' 이유비, 구릿빛 피부 공개…건강미 넘쳐	머니투데이
[화보IS] 김재경, 남다른 건강미 '걸크러시 매력'	일간스포츠
'통합 ICN KOREA GRAND PRIX' 대회 내츄럴 건강미 발산하다	뉴스타운
최은주, 명품 식스팩 복근…감탄 터지는 건강미	스포츠조선
마마무, 건강미 甲 아이돌 ‘마마무 is 뭔들’	뉴스엔
[포토] 권다정, 이것이 건강미	매일경제
[N샷] 한채아, 아이 엄마 맞아? 운동으로 완성한 건강미 넘치는 뒤태	뉴스1
김한나 치어리더, 꿀벅지로 건강미 과시 “날씨 좋았던 날” [똑똑SNS]	MK스포츠
박찬이, 여배우 뺨치는 실내 수영복 화보 "청순미+건강미"	데일리한국
소유, 신곡 '가라고' 안무 영상 공개…탄탄한 건강미	뉴스1
[포토] 이종은, '건강미 물씬~'	한국경제
셀레나 고메즈, 청량 건강미 과시…‘아이스크림’은 어떤 곡?	스포츠월드
'건강미 가득 피트니스 퀸' 이종은 화보활영 현장	CBC뉴스
소유, 나이 29살 싱글녀의 건강미 넘친 일상은? ‘온앤오프’ 출격	더리더
[포토] 건강미 넘치는 이시영	매일경제
‘나 혼자 산다’ 유이, 건강미 폭발하는 폴댄스 공개	국민일보
에바 포비엘, 건강미 넘치는 브라톱+레깅스 자태..군살이 하나도 없네	헤럴드POP
유승준 "나 잘 살아있다" 건강미 넘치는 근황 공개	매일경제
[MJ포토] 미스그랜드코리아 손지은, '건강미 넘치는 그녀'	문화저널21
차승원 홈쇼핑 출격→의리남 입증…건강미+유머러스로 완판 노린다	MBN
건강미를 뽐내는 안소현 프로 [KLPGA 에쓰오일 챔피언십]	골프한국
소유, 신곡 ‘가라고’ 깜짝 스포… "건강미 있는 느낌 강조"	이데일리
선미 '보라빛 밤' 티저 공개, 스윔수트 입고 뽐낸 건강미	한국경제
김재경, 생애 첫 언더웨어 모델 변신…건강미 넘치는 '완벽 S라인'	스포츠한국
[★포토]김유미, 건강미 넘치는 일상 "열심히 운동"	스포츠서울
‘친절한 진료실’ 김혜진, 틈새 운동+초유 단백질…건강미 비결 공개	MK스포츠
심으뜸, 건강미 넘치는 근황	미디어펜
부담스런 건강미.. '호날두 여친' 조지나, 블랙비키니로 시선 강탈	OSEN
유이, 티셔츠+레깅스 조합이 이렇게 잘 어울리다니…‘건강미’ 넘치는 근황	세계일보
'당나귀 귀' 황석정, 탄탄한 등+팔근육 '건강미'→대회 참가 결정 '최고 12.8...	스포츠조선
'이병헌 동생' 이지안, 건강미 넘치는 각선미 "볼빨간 사십대"	머니투데이
[사진]인주연,'건강미'	OSEN
류현경 `건강미` 화보 공개, "마음을 보석처럼 여기면 아름다워질 것"	디지털타임스
[화보IS] 유이, 운동으로 완성한 탄탄한 건강미	일간스포츠
[오마이포토] 'SF8' 유이, 건강미 넘치는 미소	오마이뉴스
'10월 가수 데뷔' 김해리, 대체불가 건강미 여신 '완벽 바디라인' [화보]	엑스포츠뉴스
이유비 화보, 건강미+시크한 매력으로 젠더리스 스타일까지 완벽 소화	MBN
[포토] 제이미 '옆테로 건강미 뿜뿜'	일간스포츠
유이, 운동으로 완성된 완벽 S라인 '건강미 발산'	뉴스1
래퍼 나다 "건강미 래퍼는 나다"	디지털타임스
[포토] Kei '주체할 수 없는 건강미'	일간스포츠
머슬마니아 비키니 1위 이종은 `건강미 가득` [MK영상]	MK스포츠
[N해외연예] 제니퍼 로페즈, 51세 맞아? 여전한 건강미+아름다운 미모	뉴스1
[포토] 한가빈 '옆태로 건강미 FLEX'	일간스포츠
박효주, 유튜브 채널 개설...건강미 가득 `서핑편`으로 시작	매일경제
최은경, 조각 같은 명품 근육 美쳤다..감탄 나오는 건강미	헤럴드POP
유이, 탄탄한 바디라인 드러내는 건강미 넘치는 화보 공개	MBC연예
걸그룹 소녀주의보 지성 “60kg아이돌 안녕”···건강미 넘치는 근황	스포츠경향
힙업성형, 시술 전 부작용 및 주의사항 확인해야	뉴스포인트
가희, 애둘맘의 완벽복근..믿기지 않는 40대의 건강미[★SHOT!]	OSEN
[영상] '머슬 월드클라스' 윤다연, 운동으로 완성된 건강미	뉴스1
"48세 맞아?"…최은경, 건강미 넘치는 바디프로필 공개	마이데일리
에이핑크 오하영, 테니스 룩으로 발산한 건강미! 크롭탑 아래로 포착된 '섹시...	일간스포츠
[MD포토] 배트걸, '핫팬츠 건강미'	마이데일리
효린, 'SAY MY NAME' 첫 뮤비티저 공개 예고…'건강미 폭발' 퍼포먼스 기대	RPM9
'건강미 뽐내는 선수들'	연합뉴스
[포토]동키즈 경윤, '건강미 넘쳐'	일간스포츠
[MD포토] 유현주, '건강미 넘치는 발걸음'	마이데일리
‘가짜 사나이’ 교관 아레나 화보까지 진출 ‘건강미+유쾌함’ 뿜뿜	스포츠경향
[화보] 유이, 파격 세미 누드로 뽐낸 건강미	미디어펜
유승준 "나 잘 살아있다, 아주 시퍼렇게"…건강미 넘치는 근황	마이데일리
[포토] Kei '주체할 수 없는 건강미'	일간스포츠
소유, 신곡 기습 스포일러 “태닝 도전, 건강미 살리고파”	뉴스엔
머슬마니아 비키니 1위 이종은 `건강미 가득` [MK영상]	MK스포츠
[N해외연예] 제니퍼 로페즈, 51세 맞아? 여전한 건강미+아름다운 미모	뉴스1
[포토] 한가빈 '옆태로 건강미 FLEX'	일간스포츠
박효주, 유튜브 채널 개설...건강미 가득 `서핑편`으로 시작	매일경제
최은경, 조각 같은 명품 근육 美쳤다..감탄 나오는 건강미	헤럴드POP
유이, 탄탄한 바디라인 드러내는 건강미 넘치는 화보 공개	MBC연예
[오마이포토] 'SF8' 이시영, 건강미 국가대표	오마이뉴스
걸그룹 소녀주의보 지성 “60kg아이돌 안녕”···건강미 넘치는 근황	스포츠경향
"지금의 내가 제일 좋다"..안선영, 체지방 11kg 감량 후 건강미甲 복근 노출	enews24
마마무, 화사한 컬러감의 애슬레저 웨어로 발랄한 매력과 건강미 선보여	디지틀조선일보
힙업성형, 시술 전 부작용 및 주의사항 확인해야	뉴스포인트
“건강미란 이런 것”...유이, 하의실종 파격 화보 공개 [EN스타]	서울신문
김재경, 생애 첫 속옷 화보…독보적인 '건강미'	머니투데이
가희, 애둘맘의 완벽복근..믿기지 않는 40대의 건강미[★SHOT!]	OSEN
[영상] '머슬 월드클라스' 윤다연, 운동으로 완성된 건강미	뉴스1
"48세 맞아?"…최은경, 건강미 넘치는 바디프로필 공개	마이데일리
에이핑크 오하영, 테니스 룩으로 발산한 건강미! 크롭탑 아래로 포착된 '섹시...	일간스포츠
[MD포토] 배트걸, '핫팬츠 건강미'	마이데일리
효린, 'SAY MY NAME' 첫 뮤비티저 공개 예고…'건강미 폭발' 퍼포먼스 기대	RPM9
'건강미 뽐내는 선수들'	연합뉴스
[포토]동키즈 경윤, '건강미 넘쳐'	일간스포츠
[MD포토] 유현주, '건강미 넘치는 발걸음'	마이데일리
‘가짜 사나이’ 교관 아레나 화보까지 진출 ‘건강미+유쾌함’ 뿜뿜	스포츠경향
[화보] 유이, 파격 세미 누드로 뽐낸 건강미	미디어펜
"하이힐도 OK"… 김용림, 나이 80세에도 넘치는 건강미	이데일리
[포토] 건강미 넘치는 손	매일경제
신재은 "헬멧이 몸통보다 더 커요"…건강미 넘치는 근황	미디어펜
신재은 "헬멧이 몸통보다 더 커요"…건강미 넘치는 근황	미디어펜
유현주 프로, 건강미 넘치는 뒤태+시원한 자세 영상 공개	데일리한국
[포토] 건강미 넘치는 미주	매일경제
김재경, 넘치는 에너지 발산! 탄탄한 건강미 과시(화보)	마켓뉴스
[뉴스1 PICK] '머슬 월드클라스' 윤다연 '운동으로 완성시킨 건강미'	뉴스1
'김사랑 몸 대역' 정현우 프로, 건강미 넘치는 수영복 화보...골프로 다져진 ...	일간스포츠
우주소녀 다영, 건강미 넘치는 화보…탄탄 복근까지	스포츠동아
소유 '넘치는 건강미'	뉴스1
유이, 아름다운 보디라인+건강미...세미누드 화보 공개	YTN
김연아, 여전히 여왕! 건강미 넘치는 서핑룩 '완벽 그 자체'	패션엔
소유, '가라고' 안무영상 건강미 발산	MBC연예
마마무, ‘힙 애슬레저’ 화보 공개	광주매일신문
[포토] 윤채경 '건강미가 철철'	일간스포츠
[포토] 치어리더 김하나 '건강미가 뿜뿜'	스포츠조선
[포토] 소유, '구릿빛 건강미 과시'	한국경제
황철순, 건강미 폭발	서울경제
루나, 비키니 입고 건강미 과시 `섹시 카리스마`	매일경제
박세리, 대한민국 대표 성인영양식 ‘셀렉스’ CF 촬영 현장 건강미 발산	세계일보
김사랑, 빛나는 40대 미모...자이로토닉으로 다져진 건강미	YTN
[포토]김종국, 넘치는 건강미	이데일리
치어리더 김해리, 건강미 가득 상큼비주얼 과시 [화보]	RPM9
소유, '가라고' 연습실 영상 공개…탄탄한 건강미·걸 크러쉬 매력 폭발	마켓뉴스
김연아, 건강미 넘치는 래쉬가드 자태(화보)	뉴스컬처
김빈우, 건강미 넘치는 일상 “베프와 남산서 7㎞ 걷기”[SNS★컷]	뉴스엔
[포토] 김종국, 한결같은 건강미	MBC연예
조정민, 선글라스 광고 모델 발탁…넘치는 볼륨감으로 남다른 건강미 과시	스포티비뉴스
‘원더풀’ 현아, 美친 건강미 [화보]	매일경제
‘언프리티’ 출신 나다, 싱글 ‘내몸’ 콘셉트 포토 공개…건강미 과시	MK스포츠
김유정, 애니멀 프린트 원피스 입고…건강미 '물씬'	머니투데이
유이, 아찔+과감한 화보 통해 폴댄스로 다져진 건강미 발산	MBC연예
유이, 아찔+과감한 화보 통해 폴댄스로 다져진 건강미 발산	MBC연예
공효진, 화보 통해 여전한 건강미 뽐내	MBC연예
‘친절한 진료실’ 김혜진, 건강미 넘치는 일상 공개	MBN
쌍둥이 출산 라붐 율희, 30kg 감량하고 보디수트로 건강미	스포츠경향
"체중+체지방 감소"…에바 포피엘, 건강미 넘치는 레깅스 자태	마이데일리
야노시호, 운동중인 ♥추성훈 몰래 촬영…건강미 넘치는 사랑스러운 부부	스포츠조선
소유, 신곡 ‘가라고' 안무 영상서 ‘걸 크러쉬 매력’ 폭발..탄탄한 건강미	OSEN
[포토] 우기 '우쭈쭈 건강미'	일간스포츠
‘아이콘택트’ 박기량 “옛 치어리더 건강미有, 지금 우리 팀은 아냐”	MK스포츠
'백종원♥' 소유진, 건강미 뿜뿜+군살 제로 '명품 각선미'	스포츠조선
[LIVE 포토]'MAXQ 8월호' 윤다연, 건강미의 대명사	스포티비뉴스
[포토] 김종국, 넘치는 건강미	MBC연예
자유롭고 건강미 넘치는 김연아	쿠키뉴스
현아, 건강미 넘치는 스포티+섹시美 [화보]	엑스포츠뉴스
김희정, 건강미 넘치는 화보 ‘치명적인 매력’	스포츠동아
김사랑, 민낯에도 자체 발광 `건강미 뿜뿜`	매일경제
"＃우아한 근육 ＃40대의 건강미" 안선영, 특급 몸매 공개[★SNS]	스포츠서울
유이, 완벽하게 되찾은 건강미..인형 같은 제주 소녀 [화보]	OSEN
박서준, 밥차 선물 앞 섹시 건강미 뿜뿜 "많이 탔습니다"	헤럴드POP
“클래스가 다른 아름다움”…이하늬, 건강미 넘치는 몸매 [화보]	스포츠동아
“클래스가 다른 아름다움”…이하늬, 건강미 넘치는 몸매 [화보]	스포츠동아
[포토] 소유, 건강미의 아이콘	MBC연예
이상화, 블랙 칼단발로 이미지 변신→섹시·건강미에 ♥강남, 애정폭발 "이뽀...	스포츠조선
'나혼산' 유이, 건강미 폭발 파워 폴댄스→숨겨온 솔직한 속내까지 [Oh!쎈 예...	OSEN
[MD포토] 치어리더 오채현, '건강미 넘치는 각선미'	마이데일리
[포토] 황석정, '운동으로 되찾은 건강미'	한국경제
[포토] 황석정, '건강미 넘치는 포즈~'	한국경제
'당나귀 귀' 황석정, 탄탄한 등+팔근육으로 뽐낸 건강미 '반전 매력'	엑스포츠뉴스
[MD포토] 치어리더 배수현, '건강미 가득한 깜찍함'	마이데일리
옥주현, 눈에 띄는 물오른 미모..탄탄 건강미는 덤	헤럴드POP
김준희, 연하 남편과 호캉스 예정... 건강미 넘치는 일상 [★해시태그]	엑스포츠뉴스
배우 유이, 건강미 넘치는 행보 눈길	오가닉라이프신문
[DA:리뷰] ‘라스’ 스테파니 “50대 ♥브래디 앤더슨, 건강미+재력 여전해”...	스포츠동아
'브래디 앤더슨♥'스테파니, 민소매 입고 뽐낸 건강미 "폭염 조심, 코로나 조...	헤럴드POP
강미나, 건강미 넘치는 비키니 자태…청량한 매력 [리포트:컷]	TV리포트
최강희, 건강미 비결...“난 속상하면 운동한다"	매일경제
유이, 몸매 이정도였어? 탄탄한 건강미	텐아시아
[화보] 어썸판도라, 길고 곧은 우아한 자태서도 건강미 뿜뿜!	bnt뉴스
[팝업★]"코피 �m"..옥주현, 62kg 다이어트 선언→美친 발레복 몸매로 건강미...	헤럴드POP
김해리, 10월 솔로 데뷔 앞두고 탄탄한 건강미 뽐낸 화보	뉴스엔
유승옥, 이른 아침에도 빛나는 미모 ‘건강미는 덤’ [SNS★컷]	뉴스엔
류준열, 그을린 피부+탄탄한 몸매로 완성한 '건강미' [화보]	스포츠조선
스테파니, 브라톱+레깅스 입고 반려견과 산책…넘치는 건강미	마이데일리
이시영, 흑백 뚫고 나오는 걸크러시…만능 운동러의 건강미	헤럴드POP
[포토]넘치는 건강미 선보이는 근육맨 김종국	이데일리
유이 ‘유이의 라스트핏’ 메인 MC 발탁 ‘건강미 넘치는 행보’	뉴스엔
이시영, 반바지로 뽐낸 탄탄한 각선미 ‘건강미는 덤’ [SNS★컷]	뉴스엔
13살 맞아? 이동국 딸 재시, 이국적 외모·건강미 가득한 모델로 성장	세계일보
최여진, 서핑보드 타고 건강미 뿜뿜	매일경제
가희, 빛나는 물광피부…튜브탑 입고 섹시 건강미 과시	헤럴드POP
[포토]치어리더 배수현, 미소에도 건강미 가득	일간스포츠
맥신 지선, 착 붙는 레깅스 입고 뽐낸 건강미	일간스포츠
[bnt포토] 김도연 '단아한 자태 속 돋보이는 건강미'(자연미인선발제전)	bnt뉴스
트와이스 모모, 건강미 넘치는 `금발미녀`	매일경제
모모랜드 혜빈, 건강미 넘치는 외모	스포티비뉴스
건강미 대결	뉴스1
루나, 완벽 비키니 자태... 건강미↑	TV리포트
소유, 신곡 ‘가라 고’ 트랙리스트 오픈..건강미 넘치는 각선미+감각적 연출	OSEN
루나, 검정 비키니에 '건강미' 뽐내	MBN
효린, 구릿빛 피부에 건강미 넘치는 복근까지...'독보적 섹시미'	MBN
박결 '운동으로 다져진 건강미'	윈터뉴스 코리아
전지현, 레깅스 패션도 독보적…'건강미 물씬' [화보]	마이데일리
야노 시호, 요가로 다져진 '직각 어깨' 인증…건강미 물씬	머니투데이
이혜영, 건강미 넘치는 구릿빛 피부..세련된 스타일링	헤럴드POP
김연아, 워터 레깅스·래시가드 등 건강미 넘치는 썸머룩 화보 공개	디지틀조선일보
[뷰티뉴스]한소희, 비오템 모델로 발탁! ‘건강미 담은 광고 영상 공개’	앳스타일
‘대종상 축하공연’ 박봄, 건강미&리즈 시절로 관심 폭발	스포츠경향
김빈우, 아이둘과 휴일 즐기는 중…탄탄한 건강미 [똑똑SNS]	MK스포츠
제시, 특유 건강미와 탄탄한 몸매 ‘눈길’ [화보]	스포츠동아
[포토] '건강미 물씬~'	한국경제
[포토] '건강미 과시'	한국경제
김연아, 자유롭고 건강미 넘치는 '2020 썸머 화보' 공개	스타데일리뉴스
'168cm 55kg' 안선영, 무보정 B컷 화보 공개…40대 맞아?	세계일보
[포토] 소유, 편한 차림에도 돋보이는 건강미	MBC연예
[bnt포토] 김종국 '건강미를 챙겨요'	bnt뉴스
줄리스초이스, 기은세 전속모델 발탁.... 신뢰감 있는 우아한 건강미 선보여	미래한국
유이, 핫보디 아이콘의 아름다운 건강미(화보)	뉴스컬처
나다, '내몸'으로 2년 7개월 만에 컴백..건강미 과시[Oh!쎈 컷]	OSEN
김희정, 군살 제로 건강미..튼튼 꿀벅지 '깜짝'[★SHOT!]	OSEN
현아, 美친 보디라인 자랑…넘사벽 건강미에 감탄이 절로 [화보]	헤럴드POP
방탄소년단 정국, 넘치는 건강미와 잘생김	엑스포츠뉴스
모에카, 건강미 넘치는 출근길 [포토엔HD]	뉴스엔
클라라, 밀착 브라톱+레깅스 매치…독보적인 건강미	머니투데이
마마무, 발랄한 애슬레저 룩(화보)	뉴스컬처
'50대 워너비' 박영선, 건강미 넘치는 비키니 자태..."원조 톱모델의 위엄!"	일간스포츠
[포토] 연정 '순백의 건강미'	일간스포츠
김민주 '건강미 뿜뿜'[포토]	엑스포츠뉴스
우주소녀 다영, 매거진 커버 장식… 탄탄한 복근과 건강미 ‘눈길’	MBC연예
'엉짱녀' 심으뜸, 레깅스 입고 뽐낸 건강미…'한국의 킴 카다시안'	MBN
김연아, 완벽 보디라인으로 뽐낸 건강미...`서머 레깅스 퀸`	매일경제
[bnt포토] 김종국 '흘러 넘치는 건강미'	bnt뉴스
[포토] 천온유 '건강미 가득한 미소'	스포츠조선
최여진, 감탄 나오는 독보적 건강미 [화보]	스포츠경향
'런닝맨' 데뷔 11년만 첫 출연 전효성, 건강미 넘치는 섹시댄스	중부일보
구혜선 이혼 후 14kg 감량 소식 전해...건강미 과시	쿠키뉴스
탄탄 복근에 건강미 뿜뿜… “뚱뚱해도 괜찮아, 근육이니까”	동아일보
코로나19 극복 열쇠는 '면역'…MBN 건강미박람회 오늘 온라인 개막	MBN
역시 장윤주, ‘넘사벽’ 건강미 [화보]	스포츠경향
코로나19 극복 열쇠는 '면역'…MBN 건강미박람회 내일 온라인 개막	MBN
[포토] 한혜진, 건강미 넘치는 미모	스포츠조선
[포토] 한혜진, 건강미 넘치는 미모	스포츠조선
[★화보]주예리, 레깅스 입고 건강미와 카리스마 발산	머니S
체리블렛 레미, 건강미 발산하며 인사~ [포토엔HD]	뉴스엔
유이, 바다 앞 여유로운 미소 ‘건강미’ 뿜뿜 [SNS★컷]	뉴스엔
[건강미박람회] 한돈자조금, 도뜰 ‘한돈 행복세트’ 100개 한정 20% 할인 판...	매경헬스
[포토] CLC 오승희, '건강미 넘치는 매력'	한국경제
황보, 건강미 넘치는 수영복 자태 '구릿빛 섹시美'	데일리한국
안진영 '건강미 넘치는 미소'[포토]	엑스포츠뉴스
뉴발란스, 건강미 넘치는 김연아와 썸머화보 	한국섬유신문
이시영, 반바지로 뽐낸 건강미…소유진 "예쁜 시영이"	아시아경제
김준희, 선명한 복근+굴욕 없는 레깅스 자태…'넘치는 건강미'	마이데일리
[E포토] 이시영, '건강미 넘치는 미소'	SBS funE
이동국 오남매, 훌쩍 큰 근황 ‘건강미 넘치는 근수저 가족’ [SNS★컷]	뉴스엔
네이처 하루 `건강미 가득` [MK포토]	MK스포츠
'라디오쇼' 박명수 "박세리, 밝고 건강미 넘쳐..배울 점이 많다"(종합)	헤럴드POP
김희정, 독보적 건강미 발산…다이어트도 힙하게	스포츠서울
[포토] 김종국, '넘치는 건강미'	아주경제
김연아, 래시가드 입고 건강미 발산…'퀸연아'의 강렬한 여름	조이뉴스24
김옥빈, 언더웨어 화보…탄탄한 건강미 발산	스포츠동아
김유미, 얼굴부터 몸매까지 완벽…'건강미 뿜뿜' 자체발광 미모	한국경제
김빈우, 치명적인 다리 꼬기..인형미모에 건강미까지 완벽	헤럴드POP
[포토] 두산 박소진, 건강미 넘치는 구리빛 피부	스포츠조선
나다, 건강미 담은 싱글 '내 몸' 재킷 이미지 공개	뉴스1
[포토] 치어리더 '건강미 뽐내는 댄스'	스포츠조선
이은조 '레깅스로 뽐낸 건강미'[포토]	엑스포츠뉴스
[포토] 제시, ‘넘치는 건강미’	파이낸셜뉴스
베리굿 조현, 동아TV 요즘것들서 운동용 땀복 '핫슈트'입고 건강미 과시	잡포스트
이청아, 건강미 넘치는 근황 ‘남심강탈’	한국일보
현아, 속옷 화보서 탄탄 바디라인 과시…'건강미 폭발'	엑스포츠뉴스
유현주 '건강미와 섹시미를 함께'[포토]	엑스포츠뉴스
'10월 가수 데뷔' 김해리, 러블리 미소+건강미 넘치는 몸매 '팔색조 매력' [화...	엑스포츠뉴스
'레이먼킴♥'김지우, 선명한 빨래판 식스팩에 깜짝..건강미 철철 탄탄 몸매	헤럴드POP
[포토] SF9 재윤, 뽐내고 싶은 건강미	MBC연예
김성령 “물구나무서기 너무 어려워~”…요가로 뽐낸 탄탄+늘씬 건강미	스포츠조선
김연아, 래쉬가드로 드러낸 건강미…복근까지 완벽[화보]	뉴스엔
에바 포피엘, 탄탄한 근육 과시하며 복근 노출 ‘건강미↑’ [SNS★컷]	뉴스엔
치어리더 김도희 `건강미 가득` [MK포토]	MK스포츠
'20일 출격' 키썸, 컴백 위해 8kg 감량…건강미 넘치는 S라인	한국경제
유승옥, 건강미 넘치는 비주얼 '시선 강탈'	뉴스컬처
권나라,내츄럴플러스전속 모델 발탁 "건강미 폭발"	이투뉴스
배우 박효주 유튜버 도전?…건강미 넘치는 매력 선보여	리서치페이퍼
[포토] 치어리더 장세희 '건강미 넘치는 비쥬얼'	스포츠조선
[포토] 채영, 건강미 넘치는 라인으로	매일경제
쿨 유리, 미국 LA 이민 근황..세아이 출산 후에도 구릿빛 건강미	헤럴드POP
유승옥, 밀착 미니원피스 '완벽 소화'…독보적인 건강미	머니투데이
[포토] 윤다연, '건강미 넘치는 미녀~'	한국경제
[포토] 김종국, 건강미 가득	마켓뉴스
옥주현, 건강미 넘치는 근황…이진·성유리 마음에 쏙 "이렇게 예쁘면 반칙"	뉴스컬처
구민정 '건강미 넘치는 비키니 핏'[포토]	엑스포츠뉴스
김경진 '건강미 넘치는 구릿빛 피부'[포토]	엑스포츠뉴스
[포토] 이엘 '살짝 드러난 건강미'	일간스포츠
야노시호, 운동 중인 추성훈 모습 공개..건강미 넘치는 부부[★SHOT!]	OSEN
김윤지(NS윤지), 완벽 바디라인으로 뽐낸 건강미 '시선강탈'	엑스포츠뉴스
'맥스큐' 윤다연 '매력적인 건강미'	뉴스1
우주소녀 다영, 탄탄한 복근에 건강미UP..상큼발랄 요정 같은 비주얼[화보]	헤럴드POP
장은수 `건강미 가득` [MK포토]	MK스포츠
이시영X주원, 건강미 넘치는 근육질 남매..탄탄 팔근육 시선강탈	헤럴드POP
인주연 `건강미 가득` [MK포토]	MK스포츠
[포토] 두산 치어리더 박소진, 건강미 넘치는 구리빛 피부	스포츠조선
이시영, 건강미 넘치는 일상 "너무 멋진 수락산" [★해시태그]	엑스포츠뉴스
[포토] 두산 치어리더 박소진, 건강미 넘치는 구리빛 피부	스포츠조선
이시영, 건강미 넘치는 일상 "너무 멋진 수락산" [★해시태그]	엑스포츠뉴스
"필라테스 배우며, 허리통증 사라져"…류현경, 완벽 몸매 건강미 물씬	마이데일리
AOA 설현, 농심 '켈로그' 모델 발탁…"건강미 대표 이미지 부합"	RPM9
"하체야 솟아라"..김빈우, 철저한 자기관리로 완성한 건강미[★SHOT!]	OSEN
8등신 치어리더 유하영, 건강미 넘치는 SNS 사진	스포츠경향
가희, 탄탄한 복근+화사한 미모 '건강미 여신의 매력 뿜뿜'	TV리포트
안소현 '건강미 물씬'[포토]	엑스포츠뉴스
키썸, 컴백 위해 8kg 감량…건강미 넘치는 '핫바디'로 탈바꿈	한국경제
키움 치어리더 `건강미 넘치는 율동` [MK포토]	MK스포츠
'윤종신♥︎' 전미라, 5분 운동 후 땀 뻘뻘 건강미.."참 허약해졌네"[★SHOT!...	OSEN
[MD포토] 소유 '데뷔 10년, 변함없는 건강미'	마이데일리
에바 포피엘, 성난 복근+S라인…건강미 폭발	마이데일리
김다솜, 생기 넘치는 건강미 [리포트:컷]	TV리포트
`대세` 베리굿 조현 언더웨어 모델 발탁…건강미 `물씬`	매일경제
김경화, 선명하게 드러난 식스팩 복근 ‘건강미 철철’ [SNS★컷]	뉴스엔
[포토] 단단한 건강미 선보이는 SF9 재윤	뉴데일리
진세안 '섹시한 건강미'[엑's HD포토]	엑스포츠뉴스
이시영, 등산으로 건강미 넘치는 일상 "마스크는 썼지만 행복"	헤럴드POP
푸틴, 해발 2천m서 스키 타며 건강미 과시	연합뉴스TV언론사 선정
푸틴, 해발 2천m서 스키 타며 건강미 과시	연합뉴스TV언론사 선정
문가비, 휴가철 건강미 뽐내..‘다이어트 비결은?’	서울신문
가희, 수준급 웨이크서핑 실력 공개‥넘치는 건강미[SNS★컷]	뉴스엔
고우리, 몸짱 대열 합류…복근으로 섹시 건강미 과시	헤럴드POP
[포토] 두산 박소진, 건강미 넘치는 구리빛 피부	스포츠조선
박신혜, 건강미 넘치는 각선미 [MK포토]	MK스포츠
아이즈원 이채연, 돋보이는 건강미 [MK포토]	MK스포츠
김준희, 건강미 넘치는 구릿빛 피부..♥연하 남편이 반한 섹시함	헤럴드POP
[포토] 양정원 '건강미로 거머쥔 대상'	일간스포츠
안소현 `건강미 가득...필드 여신` [MK화보]	MK스포츠
[포토] 김원효, 건강미 물씬?	스포츠서울
‘60kg 아이돌’ 소녀주의보 지성, 레깅스 입고 뽐낸 보디라인 [똑똑SNS]	MK스포츠
김정난, 49세 믿기지 않는 건강미..윤세아도 감탄한 플라잉요가[★SHOT!]	OSEN
김종국, 흘러넘치는 건강미 '퍼펙트 하죠?' [MD동영상]	마이데일리
"가녀림보단 근육질 건강미"…여성들도 '벌크업' 나선다	연합뉴스
[MD포토] 김종국 '헬스기구 옆에서 넘치는 건강미 발산'	마이데일리
KT 치어리더 '건강미 뽐내며'[엑's HD포토]	엑스포츠뉴스
유이, 거식증 루머 심경고백→'파격' 세미누드 공개→건강美 발산[종합]	엑스포츠뉴스
양정원, 광고 촬영 비하인드컷…독보적 건강미	엑스포츠뉴스
유현주, 건강미 넘치는 미소 [MK포토]	MK스포츠
츠보미, 건강미 넘치는 비주얼 '스마일'	뉴스컬처
루나, 수영복 입고 뽐낸 건강미..개미허리+애플힙 완벽 몸매[★SHOT!]	OSEN
‘8kg 증량’ 선미, 50kg 인증…건강미 UP	헤럴드경제
유현주 '건강미 넘치는 구릿빛 피부'[포토]	엑스포츠뉴스
인주연 `건강미 넘치는 발걸음` [MK포토]	MK스포츠
[포토] 이시영, '건강미 넘치는 그녀'	한국경제
양수빈, 건강미 넘치는 운동하는 일상 '시선 강탈'	뉴스컬처
이시영, 건강미란 이런 것 ‘탄탄 각선미+밝은 미소’ [SNS★컷]	뉴스엔
[포토] 채리나, 건강미 넘치는 미모	매일경제
김희정, 건강미에 더한 몽환적 분위기…치명적인 매력 [화보]	엑스포츠뉴스
이시영, 수락산 암벽 등반까지..건강미 넘치는 일상 [★SHOT!]	OSEN
[포토] 치어리더 이주아 '건강미 뿜뿜~'	스포츠조선
동키즈 경윤, 건강미가 넘쳐[포토엔HD]	뉴스엔
'멋진 패션+건강미 넘치는 외모' 유현주 생애 첫 승 도전	윈터뉴스 코리아
[포토] KT 치어리더 '군살 하나 없는 건강미'	스포츠조선
[포토] 우기 '고혹적인 건강미'	일간스포츠
치어리더 김진아, 건강미 넘치는 각선미 [MK포토]	MK스포츠
머슬퀸 백성혜 `구릿빛 건강미 과시` [MK포토]	MK스포츠
조여정, 촉촉한 피부로 건강미 발산···고혹적인 미모 '시선 강탈'	텐아시아
이시영, 감탄 절로 나오는 '명품 식스팩'..넘사벽 건강미	스타뉴스
유이, 요가로 다져진 건강미…"나를 사랑해주는 것이 건강한 삶"	MBN
키썸, 컴백 위해 8kg 감량…건강미 넘치는 S라인 완성	매일경제
'나 혼자 산다' 유이, 폴댄스로 탄탄한 몸매+건강미 과시	톱데일리
한채아, 건강미 가득 수영복 화보 공개	스포츠서울
유현주, 건강미 돋보이는 티샷 [MK포토]	MK스포츠
[포토S] 오지현, 건강미 뽐내며	스포티비뉴스
'레이먼킴♥︎' 김지우, 다이어트 하더니 인형미모..탄탄 건강미[★SHOT!]	OSEN
소녀시대 수영, 첫 속옷 화보 공개…건강미 '물씬'	머니투데이
김지훈, 탄성 자아내는 핫바디…건강미 넘치는 비하인드 컷	엑스포츠뉴스
바바라 팔빈, 리조트 화보…수영복 자태 "건강미 물씬"	머니투데이
'♥정경호' 수영, 언더웨어 화보서 건강미 넘치는 '봄의 여신'[화보S]	스포티비뉴스
고진영 '건강미 넘치는 미소'[포토]	엑스포츠뉴스
［화보］정지훈(비), 독보적 건강미+완벽 비율..‘청청 패션’마저 퍼펙트	브레이크뉴스
방탄소년단 정국, 건강미 넘치는 ‘만찢남 비주얼’	엑스포츠뉴스
[건강미박람회] 온라인 개최 D-1, 경품이벤트 챙겨보기	매경헬스
뉴트리원, 건강기능식품 6종 기획세트 '건강미 플러스'출시	미래한국
이열음, 군살 하나 없는 개미허리+복근..건강미 끝판왕	헤럴드POP
[포토] (여자)아이들 민니, '건강미 넘치는 그녀'	한국경제
47세 변정수, 중년 말벅지 건강미…딸과 환상 비키니로 시선 집중 [화보]	스포츠경향
키썸, 컴백 위해 8kg 감량…건강미 넘치는 S라인 눈길	헤럴드POP
유현주 '건강미 넘치는 미소'[포토]	엑스포츠뉴스
유승준, 건강미 넘치는 근황…감탄 자아내는 팔근육	헤럴드POP
소유, 건강미 넘치는 구릿빛 복근 드러내고~[포토엔HD]	뉴스엔
"개운"...박소진, 운동 후 건강미 발산 [★해시태그]	엑스포츠뉴스
[포토] 배트걸 변신한 치어리더 박혜인 '건강미 뿜뿜'	스포츠서울
건강미 넘치는 이시영	연합뉴스
[건강미박람회] 언택트 시대, 박람회도 라이브커머스	매경헬스
8Kg 늘린 선미, 건강미 '뿜뿜'(화보)	텐아시아
'나 혼자 산다' 한혜진, '섹시에 건강미 더한 매력'	씨네21
소유 나이, 29세 깨달은 건강미 "마른건 안 어울려"('온앤오프')	데일리한국
유현주 '건강미 넘치는 팔근육'[포토]	엑스포츠뉴스
[포토]건강미 뽐내는 김종국	스포츠서울
"건강미·클럽취미 OK"...한예슬, '미우새'母 사로잡은 솔직매력	YTN
조현, 탄력 복근&섹시美..건강미 넘치는 레깅스 패션	스타뉴스
키썸, 컴백 전 8kg 감량 '건강미 넘치는 S라인'	마이데일리
김희정, 다이어트 CF로 건강미 과시	한스경제
[건강미박람회] 코로나19 위기극복, 개최기간 21일까지 연장	매경헬스
8KG 늘린 선미, 건강미 넘치는 '날라리' 퍼포먼스[카메라톡스]	스포츠서울
조여정, 어깨라인 드러내며 건강미 발산	뉴스컬처
유이, 과감한 세미 누드…아름다운 건강美 [화보]	TV리포트
손승연, 완벽한 힙업 뒤태…건강미+섹시미 다 가졌네	마이데일리
[포토]선미, 8kg 체중 증량 '건강미'	이데일리
[포토] 윤다연, 섹시한 건강미	디지털타임스
두산 치어리더 '건강미 뿜뿜'[엑's HD포토]	엑스포츠뉴스
"찍기만 해도 화보" 한영, 건강미 넘치는 수영복 자태	스포츠조선
마마무 화사, 건강미 넘치는 수영복 자태…시선강탈 S라인 [★해시태그]	엑스포츠뉴스
[MD포토] 피트니스 모델 박은혜, '탄탄한 건강미'	마이데일리
[포토]김종국, 건강미 넘치는 브이	헤럴드POP
[SR연예] 걸그룹 소녀주의보 지성 건강미 넘치는 근황 공개	SR타임스
김희정, 구릿빛 피부에 빛나는 몸매…건강미 넘치네	마이데일리
인주연 '건강미 넘치는 모습'[포토]	엑스포츠뉴스
나다,무대를 압도하는 건강미 [포토엔HD]	뉴스엔
선미, 8㎏ 늘리고 몸매 ‘탄탄’.. 컴백 앞두고 건강미 더해진 수영복 사진 공...	세계일보
선미, 수영복 자태 공개...8kg 증량 후 건강미UP	YTN
이다희, 감탄 나오는 유연성..플라잉 요가로 뽐낸 군살제로 건강미	헤럴드POP
[포토]건강미 발산하는 김종국	스포츠서울
'나 혼자 산다' 유이, 건강미 폭발하는 풀 파워 폴 댄스! 파워는 완성! 유연성...	엔터미디어
제시, 레깅스+탱크톱으로 뽐낸 건강미	MBN
우주소녀 다영, '필라테스S' 3월호 커버…건강미 뽐내	TV리포트
[화보] 청순·건강미 넘치는 설현	노컷뉴스
‘아내의맛’ 영탁, 남승민 옥탑방 방문…30대 후반의 건강미 과시	뉴스엔
김유정, 래시가드로 드러낸 탄탄 복근 ‘건강미 폭발’[화보]	뉴스엔
한영, 건강미 넘치는 수영복 자태 공개…찍기만 해도 화보	한국경제TV
[사진]SF9 재윤, '건강미 뽐내며'	OSEN
김연아, 청량한 크롭트 톱+레깅스 매치…건강미 '물씬'	머니투데이
조정민, 건강미 넘치는 수영복 자태 '화보 같은 일상'	아시아투데이
트와이스 지효 '건강미 발산'[엑's HD포토]	엑스포츠뉴스
마마무 화사, 끈나시 하나로 완성한 섹시룩..'압도적 건강미'[★SHOT!]	OSEN
[사진]박은혜,'건강미 넘치는 보디라인'	OSEN
[포토] LG 치어리더, 건강미 넘치는 몸매	스포츠조선
[포토] 머슬퀸 윤다연, 건강미 가득	디지털타임스
[HD포토] "구릿빛 건강미"ㅣ'마마무' 화사	디스패치
김사랑, 건강미 넘치는 근황..40대 나이 무색한 美친 동안 미모 '화제' [종합...	OSEN
'해피투게더4' 조나단 "홍현희, 콩고에서 전지현…건강미 넘쳐"	뉴스1
[포토]이시영, 건강미 뽐내며	스포츠서울
포뉴 내몸애착, 광고모델로 김동은 원장 발탁…"건강미 매력 발산"	미래한국
[TEN PHOTO]체리블렛 레미 '건강미가 넘쳐'	텐아시아
한영, 제주도 여행 사진 공개...건강미 넘치는 수영복 자태 '시선'	한국경제
'미녀 골퍼' 유현주 프로, "누가 내 옷에 구멍냈나?" 건강미 폭발	뉴스컬처
김연아, 뉴발란스 여름 화보 통해 건강미 발산	서울신문
한혜진 '건강미 넘치는 미소'[★포토]	스타뉴스
설현 화보 촬영 비하인드컷 공개…운동 욕구 일으키는 건강미 여신	데일리한국
이가은의 남다른 건강미… 무결점 화보 비하인드 컷	MBC연예
[MD포토] 건강미 넘치는 유현주 '심각한 고민?'	마이데일리
이하늬, 독보적인 건강미 [화보]	스포츠동아
현아, 스포티한 레깅스 패션…건강미 '물씬'	머니투데이
[포토] 배트걸 권안나 '건강미 뿜뿜'	스포츠서울
[포토] 이대원-이종은. 다채로운 건강미	매일경제
[포토] 머슬퀸 이종은, 건강미 넘치는 하트	매일경제
이하늬, 싱그러운 건강미 물씬…민낯도 자신있게	조이뉴스24
“건강미 가득”…레이디티, 스포츠제품 전속모델 발탁	MK스포츠
류세미, 건강미 넘치는 자태 (대한민국 예술문화인대상)	서울경제
[포토] 있지 리아 '건강미 발산하는 데뷔 무대'	스포츠조선
유현주, 건강미 넘치는 근접 촬영 사진 공개 [in스타]	엑스포츠뉴스
[포토] 이유 '이유 있는 건강미'	일간스포츠
'코로나19 극복, 착한소비 촉진' 제11회 MBN건강미박람회 진행	MBN
에바, 섹시 복근 깜짝 공개…넘쳐 흐르는 '건강미'	데일리한국
[포토] 박은혜-백성혜, 시선을 압도하는 건강미	일간스포츠
[포토S] 인주연, 건강미 뽐내며	스포티비뉴스
루나, 건강미 넘치는 구릿빛 탄탄 몸매	스포츠한국
루나, 건강미 넘치는 구릿빛 탄탄 몸매	스포츠한국
삼성 치어리더 '건강미 뿜뿜'[엑's HD포토]	엑스포츠뉴스
류화영 "#건강미 #섹시한 #종아리알" 테니스 여신의 셀피 한 컷	인천일보
오마이걸, 신곡 '번지(BUNGEE)' 개인 티저 공개…건강미 넘치는 상큼한 스타일...	한국경제TV
'나혼산' 박나래·헨리, 건강미 하루→시청자 웃음꽃	스타뉴스
이예진, 비키니 입고 건강미 발산	서울경제
이예진, 건강미 넘치는 바디라인	서울경제
[bnt포토] 조여정 '건강미 넘치는 미소'	bnt뉴스
[사진]인주연,'건강미'	OSEN
김희정, 건강미 넘치는 '워너비 몸매' 담은 티저 영상	일간스포츠
김희정, 건강미 넘치는 '워너비 몸매' 담은 티저 영상	일간스포츠
'경이로운 소문' 측 "김세정, 데뷔 이래 가장 파격 변신"	서울경제
'나 혼자 산다' 박나래-헨리, 웃음+힐링 두 마리 토끼 다잡은 건강미 가득한 ...	MBC연예
유현주 '미녀 골퍼의 건강미'[포토]	엑스포츠뉴스
유이 파격 화보, 아찔 세미누드 공개…청순 미모+절제된 건강미 발산	글로벌이코노믹
[MD포토] 손담비, '건강미 넘치는 손인사'	마이데일리
나르샤, 꾸준한 관리+다이어트의 결과물 '건강미 폭발'[화보]	스포츠조선
효린, 독보적 건강미美 [화보]	스포츠동아
"50kg 돌파"…선미, 몸무게 증량으로 건강미 과시→팬들 응원 [종합]	엑스포츠뉴스
[MD포토] 치어리더 배수현, '건강미 가득한 몸매'	마이데일리
치어리더 하지원 `건강미 넘치는 응원` [MK포토]	MK스포츠
[건강미박람회] 아리아케어, 방문요양∙주야간보호 서비스 소개	매경헬스
[포토] 설리, 브라탑으로 뽐낸 ‘성숙한 건강미’	서울신문
[건강미박람회] 한국케어테크협회, 초고령 사회 미래 돌봄 신기술 선보여	매경헬스
'여신강림' 야옹이 작가, 건강미 넘치는 일상	미디어펜
[사진]SK 이미래 치어리더,'돋보이는 건강미'	OSEN
[건강미박람회] ‘슬기로운 건강생활’ 영상공모전 도전하세요	매경헬스
한혜진 '건강미 뽐낸 드레스 자태'[엑's HD포토]	엑스포츠뉴스
손연재, 상큼 팡팡 터지는 미소...건강미 넘치는 '11자 복근은 덤'	뉴스컬처
이청아, 건강미 넘치는 일상…탄탄한 복근 '시선 강탈' [★해시태그]	엑스포츠뉴스
‘경이로운 소문’ 측 “김세정 데뷔 이래 역대급 파격 변신”	스포츠동아
[MD포토] 윤다연 '매력적인 건강미'	마이데일리
[★포토]오정연 '건강미 넘치는 각선미'	스타뉴스
이기우, 푸름웰니스 전속 모델 계약 체결 "건강미+신뢰도↑" [공식입장]	MBC연예
'20kg 감량' 김빈우, 운동으로 다진 탄탄 몸매..애둘맘 완벽 건강미	헤럴드POP
K 뷰티니스, 심지은 '건강미가 넘치네'	시민의소리
[포토] 백성혜-박은혜 건강미 과시한 비키니화보	일간스포츠
설현, 당당한 건강미로 다채로운 매력 발산	한국경제TV
‘컴백’ 강다니엘, 美 LA서 건강미 넘치는 모습	뉴스엔
[MD포토] 치어리더 배수현, '탄탄한 건강미'	마이데일리
‘애둘맘’ 김빈우, 남산 둘레길 걷기 인증샷 “눈부신 건강미”	TV리포트
건강미 넘치는 줌바 마스터 클래스	연합뉴스
[포토] 윤다연, 남심 저격 미소와 건강미	디지털타임스
‘넘사벽 건강미’ 배우 강소라, 세리박스 뮤즈 된다	브릿지경제
AOA 설현, 청순-건강미 넘치는 여신 [화보]	서울경제
'♥이용규' 유하나, 건강미 가득 느껴지는 탄탄한 몸매 화제	뉴스컬처
클라라, 운동으로 가꾼 명품 복근…건강미 물씬	마이데일리
하정우 “이선균, 특유의 따뜻함과 건강미 있는 형” [화보]	스포츠동아
이런 `건강미 넘쳐` [MK포토]	MK스포츠
"건강미가, 물씬"…김희정, 화보 비하인드컷도 독보적	마이데일리
"건강미가, 물씬"…김희정, 화보 비하인드컷도 독보적	마이데일리
건강미 넘치는 마마무 화사 (2018 KBS 연예대상)	서울경제
화사 보다 빠르게... 건강미 넘치는 화보에 시선 '확'	스마트에프엔
[포토] 치어리더 배수현 '건강미 뿜뿜'	스포츠서울
[포토] 두산 치어리더 박소진, '건강미 넘치는 몸매'	스포츠조선
네온펀치 백아, 건강미 물씬 (네온펀치 쇼케이스)	서울경제
'미녀골퍼' 안소현 프로, 건강미 넘치는 일상 사진 화제	뉴스컬처
유현주 `건강미 넘치는 몸매` [MK포토]	MK스포츠
건강미 뿜뿜! 못말리는 근육질 소녀	일요신문
오마이걸, 신곡 '번지(BUNGEE)' 개인 티저 공개..건강미+상큼 스타일링	서울경제
이주연, 언더웨어 화보 비하인드 컷…돋보이는 건강미 ‘눈길’	한국경제TV
유현주 `건강미 넘치는 몸매` [MK포토]	MK스포츠
우주소녀 다영, 건강미 물씬 컬러 화보 전격 공개…'탄탄한 복근과 건강미'	매일일보
'8kg 증량' 선미, 50kg 인증..더해진 건강미에 응원UP[★NEWSing]	스타뉴스
[포토] 류진 '촉촉한 건강미'	일간스포츠
김희정, 화보 비하인드컷 공개...'러블리+건강미'	TV리포트
김도연, 필라테스 다져진 몸매..건강미 물씬 [★SHOT!]	OSEN
전소미, 선명한 복근+탄탄한 몸매…필라테스로 건강미 넘치는 근황 공개	스포츠조선
한화이글스 김연정 치어리더, 건강미 넘치는 몸매 화제	뉴스컬처
건강미 넘치는 탄탄한 복근을 가진 스타 4위 설현, 2위 비… 1위는?	디지틀조선일보
신재은 "광고 촬영 왔어요"…건강미 넘치는 근황	미디어펜
한영, 제주도 여행 인증…건강미 넘치는 수영복 자태	매일경제
[포토] 조혜지, '건강미 넘치는 자태'(WSTMS 시즌4)	뉴스프리존
조여정, 건강미 vs 청순미 반전 매력 발산	한국경제TV
[건강미박람회] 애경, 구강건강 챙기는 덴탈케어 ‘에어화이트’ 선보여	매경헬스
오마이걸, 건강미 넘치는 상큼미… 청량함 한가득	스포츠월드
나나 (우아!) ‘배꼽티로 드러낸 건강미’[포토엔HD]	뉴스엔
[포토] 이대원-이종은, 건강미 넘치는 화보 촬영장	매일경제
조현, 건강미 넘치는 비주얼에 시선 고정...'비율 천재'	뉴스컬처
유현주 `건강미 넘치는 몸매` [MK포토]	MK스포츠
‘이거 CG 아냐?’…이시영, 건강미 넘치는 바디 자랑 [스타★샷]	스포츠월드
[화보] 유이, 공개된 화보 속 남다른 건강미 눈길	내외뉴스통신
선미, 몸무게 50kg 인증샷 공개…건강미 '물씬'	머니투데이
윤다연 '건강미와 섹시미를 동시에'[엑's HD포토]	엑스포츠뉴스
엄정화, 첫 웨이크서핑으로 건강미 뽐내…"이거 영화야?"	헤럴드경제
정다래, 섹시미+건강미 ‘부족한 게 없는 수영복 자태’ [SNS★컷]	뉴스엔
청순한 비주얼과 대조되는 탄탄한 '잔근육'으로 건강미 뽐내는 김세정	인사이트
옵스킨(OPSKIN) '틴 콜라겐', '제11회 MBN 건강미박람회' 참가	비즈월드
[건강미박람회] 뷰티 꿀팁 전수하는 김기수	매경헬스
'경이로운 소문' 김세정 액션 스틸…"데뷔 이래 가장 파격적인 변신"	뉴스1
`치어리더 여신` 박기량, 광고로 뽐낸 탄탄 건강미	매일경제
[포토] 배수현 '건강미가 뿜뿜'	스포츠조선
박봄, 대종상서 건강미 넘치는 비주얼…수상자 제치고 시선 '싹쓸이'	스포티비뉴스
예리 "필라테스 신이 될 거야" 건강미 뿜뿜	스타뉴스
머슬퀸 이예진, 건강미 넘치는 비주얼	서울경제
건강미 넘치는 화사	연합뉴스
[포토] 이연희 '살짝 드러난 건강미'	일간스포츠
닮고 싶은 건강미 넘치는 몸매의 남자 스타 1위 김수현, 2위 박서준… 그 밖의...	디지틀조선일보
[포토] 안현모 '건강미 발산하며 입장'	일간스포츠
[사진]아이즈원 김민주,'건강미 넘치는 복근'	OSEN
ITZY(있지), 사랑스러운 비주얼＋건강미 넘치는 래시가드 핏	스포츠동아
[MD포토] 강예빈, '건강미 넘치는 손인사'	마이데일리
‘경이로운 소문’ 김세정, 러블리 지우는 ‘치명 걸크러시’ 폭발	한국경제TV
이가은, 감탄사를 이끄는 건강미 넘치는 화보 비하인드 컷 공개	뉴스타운
설현, SNS로 건강미 넘치는 복근 공개	스포츠경향
오나미, 마른 비만→건강미 넘치는 복근 생성…바디프로필 공개	톱스타뉴스
'금수저 모델' 벨라 하디드, 수영복 화보…건강미 '물씬'	머니투데이
‘골프 걸그룹’ 레이디티, 스포츠제품 전속모델 계약 “건강미와 젊은 에너지...	스포츠동아
클라라, 플라잉요가로 뽐낸 무결점 S라인 '건강미 철철'	마이데일리
[화보] 한보름 스포티 패션으로 건강미 과시	노컷뉴스
[화보] 한보름 스포티 패션으로 건강미 과시	노컷뉴스
[MD포토] 치어리더 '건강미 돋보이는 각선미'	마이데일리
[포토] 장윤주, 건강미 넘치는 미소로	매일경제
[포토] 소이현 '블루여신의 건강미'	일간스포츠
[MD포토] 김연아 '건강미 넘치는 미모'	마이데일리
[포토S] 유현주, 건강미 뽐내며	스포티비뉴스
[포토] 추수빈 '여의도 밝힌 건강미'	일간스포츠
양정원, 건강미 넘치는 탄탄 바디라인…'역시 필라테스 여신'	엑스포츠뉴스
클라라, 밀착 레깅스 차림에 한 마리 새 자태…건강미 가득 [똑똑SNS]	MK스포츠
소유, 풋풋 ‘Push Push’→ HIP&건강美 ‘GOTTA GO’까지 [이남경의 ARS]	MBN
[포토] 치어리더 '건강미 발산'	스포츠조선
레이양, VR 노래방 '부르존' 출연… 건강미·섹시미 동시 어필	이데일리
‘we go the power’ 소녀주의보, 건강식품 모델 발탁…“건강미 잘 어울려”	MK스포츠
유빈, 건강미 넘치는 11자 복근..."2020 첫 운동"	매일경제
스포라이브, ‘건강미’ 앞세운 치어리더 이하윤 앰버서더 선정	베스트일레븐
[MD포토] 치어리더 차영현, '건강미 넘치는 응원'	마이데일리
최완정, 머슬 앤 모델 ‘아시아 챔피언’ 다운 건강미 [포토엔HD]	뉴스엔
소유, 건강미의 대명사 [화보]	스포츠경향
유현주 `건강미 넘치는 몸매` [MK포토]	MK스포츠
[포토] 치어리더 '건강미 넘치는 복근'	스포츠조선
두산베어스 서현숙 치어리더, 건강미 가득 느껴지는 비주얼 눈길	뉴스컬처
'경이로운 소문' 김세정, 강렬 눈빛 포착..치명 걸크러시 폭발	헤럴드POP
AOA 설현, 청순-건강미 넘치는 뷰티화보 공개	MBC연예
설현, 청순·큐티·섹시 매력 속 건강미 발산	이데일리
'진화♥︎' 함소원, 뱃살 無 건강미 넘치는 몸매.."관리하는 여자" [★SHOT!]	OSEN
이솜, 건강미 넘치는 모습 ‘다이어트 자극되네’ [화보]	스포츠동아
[포토] 현아, 건강미 발산	이데일리
노스페이스, 건강미 넘치는 '신민아' 새로운 뮤즈 발탁	패션엔
'♥이대은' 트루디, 건강미 물씬 풍기는 사진 '시선 강탈'	뉴스컬처
에바 포피엘, 건강미 넘치는 몸매…탄탄한 복근 눈길	마이데일리
[포토] 치어리더 '건강미 뽐내는 댄스'	스포츠조선
'미우새' 김종국父, 캐나다서 반전 상남자 매력 '나이무색 건강미'	헤럴드POP
[SC포커스] 낸시 '건강미와 청순미 다 잡은 핫팬츠 패션'	스포츠조선
[MD화보] '건강미를 보여줄게'…배수현, 딱 봐도 운동한 몸	마이데일리
정다래, 섹시한 수영복 차림으로 건강미 뿜뿜	스타뉴스
'경이로운 소문' 측 "김세정, 데뷔 이래 가장 파격 변신"	엑스포츠뉴스
AOA 설현, 청순-건강미 넘치는 뷰티화보 공개	국방일보
50kg대 접어든 선미, 건강하고 탄탄해졌다…수영복 입고 건강미 발산	스포츠경향
"동안 미모"..가희, 튜브톱으로 뽐낸 완벽 건강미[★SHOT!]	OSEN
건강미 넘치는 오하영	연합뉴스
윤세아, 자기관리 끝판왕..필라테스로 뽐낸 탄탄 건강미	헤럴드POP
[MD화보] '필드서 더 빛나'…유현주, 건강미 넘치는 구릿빛 피부	마이데일리
이하늬 셀카 사진 속 건강미 넘친 미소…"영국 아닌 한국 지방 촬영 중"	데일리한국
마마무 화사, 치명적인 눈빛+건강미 넘치는 몸매…일상도 힙하네	마이데일리
"선명한 복근" 이청아, 탄탄한 보디라인 '건강미↑'	일간스포츠
클라라, 건강미 넘치는 핫보디 '선명한 11자 복근까지'	스포츠한국
[포토] 시그니처 선 '건강미 발산하는 댄스'	스포츠조선
설리, '캘빈클라인 퍼포먼스' 화보 공개…"건강미 넘쳐"	머니투데이
'연애혁명' 우주소녀 다영, 복싱장에서 뽐낸 걸크러시..탄탄한 몸매	OSEN
소유진, 건강미 넘치는 일상...프로등산러 인증 "#청계산"	뉴스컬처
메디코이, '안티에이징 5종 세트'로 'MBN 건강미박람회' 참가	머니투데이
선미 50kg 돌파…누리꾼 “건강미 넘치는 모습 아름다워” 응원	MK스포츠
류현경, 건강미 넘치는 각선미 [MK포토]	MK스포츠
이시영, 트레이닝 레깅스에도 군살 제로 몸매 '부러운 건강미'	헤럴드POP
김희정, 구릿빛 피부+탄탄 몸매로 '섹시 건강미' 뿜뿜	헤럴드POP
최수영 뽐낸 건강미, 스포티룩의 정석[화보]	뉴스엔
건강미 뽐내는 문가비·김희정	뉴시스
꾸뿌, 건강미 자랑하며	뉴스1
"매회 리즈 갱신" 조여정, 건강미VS청순미 '반전' 매력	스포츠조선
［화보］유이, 건강미 넘치는 탄탄한 바디라인+독보적 비주얼 ‘시선강탈’	브레이크뉴스
[포토] 윤다연, 건강미 넘치는 그녀~	스포츠동아
김연아 `건강미 넘치는 보디라인` [MK포토]	MK스포츠
[포토] 치어리더 '건강미 넘치는 워킹'	스포츠조선
조여정, 건강미와 청순미 오가는 반전매력	텐아시아
김희정, 비키니·트레이닝복까지 완벽 소화…건강미 넘치는 매력 [화보]	엑스포츠뉴스
[포토] 드림노트 은조 '눈부신 건강미'	일간스포츠
김민경 표지모델, "도회적인 포즈로 건강미 발산"	폴리뉴스
임신소식 민영원, 넘치는 건강미…차세대 출산의 여왕?	MK스포츠
'정법' 예인, 그림같은 정글 일출에 건강미 넘치는 스트레칭 [★밤TView]	스타뉴스
[포토] 청하 '건강미 뽐내는 댄스'	스포츠조선
남지현, 건강미 넘치는 미소와 각선미 [MK포토]	MK스포츠
김재경, 언더웨어 모델 발탁… 탄탄한 건강미 뽐내	머니S
유이, 꿀벅지 레전드 다운 핫 바디 공개...건강미 넘치는 싱글즈 7월 호 커버	한국면세뉴스
'건강미 넘치는 일상…가희, 튜브톱 의상 입고 뽐낸 탄탄한 복근	마이데일리
[포토S] 치어리더 하지원, 건강미 넘치는 몸매	스포티비뉴스
'미우새' 한예슬 이상형 질문에 "건강미가 넘치는 스타일이 좋다"	뉴스1
[더셀럽포토]마마무 '건강미의 정석'	더셀럽
김희정, '건강미+몽환적 분위기' 발산하는 유니크한 매력 [화보]	TV리포트
박소진, 건강미 넘치는 근황..."개운"	뉴스컬처
고은민, 건강미 넘치는 운동 근황...마스크 뚫는 '깜찍' 매력	뉴스컬처
김나정 아나운서, 건강미 넘치는 일상 화제	뉴스컬처
올리브영, '건강미' 강조한 신규 캠페인 '날아라 올리브'	아시아경제
가희, 건강미 넘치는 자태 "유튜브 잘하는 공부 中"	헤럴드POP
'건강미란 이런 것'	연합뉴스
'건강미 大폭발'…레이양, 단추 풀고 드러낸 볼륨	스포츠서울
김라라, 건강미와 청숭미를 동시에 [MK포토]	MK스포츠
'전 수영 얼짱' 정다래, 섹시+건강미 넘치는 수영복 몸매 [★해시태그]	엑스포츠뉴스
[bnt포토] 한다감 '넘치는 건강미'	bnt뉴스
[포토] '건강미 물씬~'	한국경제
아이스하키 선수로 변신한 푸틴…건강미 과시	연합뉴스TV언론사 선정
아이스하키 선수로 변신한 푸틴…건강미 과시	연합뉴스TV언론사 선정
AOA 설현, 청순함+건강미 다했다[화보]	헤럴드POP
[포토] 이호정, '건강미 넘치는 비주얼'(디올 뷰티)	뉴스프리존
이하늬, 독보적 건강미..청바지만 입어도 ‘섹시’	MK스포츠
고민시, 건강미 넘치는 비주얼에 시선 고정...'미소는 덤'	뉴스컬처
네온펀치 테리, '건강미로 완성한 포스'	서울경제
베리굿 조현 운동 인증샷, 늘씬 몸매 `건강미 뿜뿜`	매일경제
손나은, '건강미 가득한 발걸음'	서울경제
배수현 치어리더, 건강미 넘치는 일상 눈길	뉴스컬처
배그린 42kg→51kg, 박신혜 조언으로 건강미 넘쳐 ..파격 수영복 [화보]	서울경제
황신혜, 황금비율에 더한 건강미 비결 “먹기 위해 운동” [SNS★컷]	뉴스엔
"건강미 넘치는 섹시함"…한보름, 화보 비하인드	스포츠조선
ITZY 채령, 라임처럼 상큼한 건강미+발랄 매력	마이데일리
'50kg 돌파 인증샷' 공개한 선미… 건강미 물씬	세계일보
[ST포토] CLC 장승연, '돋보이는 건강미'	스포츠투데이
[포토] 걸스데이 소진 '건강미 담당하는 MC'	스포츠조선
이한별, 건강미 넘치는 비주얼 시선을 압도하 각선미	일간스포츠
[TEN PHOTO]하정우 '건강미 넘치는 미소'	텐아시아
[포토] 두산 박소진, 건강미 넘치는 몸매	스포츠조선
클라라, 크롭 티셔츠+레깅스 입고 뽐낸 11자 복근 '건강미 뿜뿜'	마이데일리
손예진, 건강미도 최고! [MK포토]	MK스포츠
"넘사벽 다리 길이"…한영, 건강미 넘치는 비키니 자태	마이데일리
김희정, 준PO 4차전 시구..복근 드러낸 '건강미'	뉴스1
[TEN 포토] 나다 '건강미 넘치는 구리빛 피부'(쇼챔피언)	텐아시아
[POP이슈]유이, 애프터스쿨 시절 꿀벅지‥파격 세미누드로 거식증 루머 타파	헤럴드POP
[★포토]AOA 설현, 청순-건강미 넘치는 뷰티화보 공개	스포츠서울
'경이로운 소문' 김세정, 캐릭터 스틸컷 공개···역대급 파격 변신 예고	일간스포츠
[포토] 김종국, 건강미 철철~	스포츠서울
[포토] 치어리더 '건강미가 뿜뿜'	스포츠조선
[포토]제인 '건강미 뿜뿜'	이데일리
[오마이포토] 건강미 돋보이는 AOA	오마이뉴스
“섹시함 그 자체...” 구릿빛 피부로 건강미 뽐낸 여자 아이돌들	위키트리
AOA 설현, '건강미 가득한 미소'	서울경제
소유, 새 싱글 ‘GOTTA GO’ 크레딧 티저 공개…'건강미&당당함' 눈길	RPM9
[MHN포토] 하니 '건강미 넘치는 매력'	문화뉴스
이하늬, 롱패딩 입고도 섹시..건강미 뽐내	이데일리
건강미 넘치는 유승옥	연합뉴스
효린 ‘바다보러갈래’, 오늘(20일) 공개…‘건강미 넘치는 섹시美’	MBN
[포토] 유나, 건강미 넘치는 미소	매일경제
효민, 요가복 입고 완벽 뒤태 자랑..건강미 뿜뿜	스타뉴스
설현, '당당한 건강미' 뷰티헬스케어 화보 공개	스포츠서울
'경이로운 소문' 김세정, 러블리 지우는 '치명 걸크러시'…"데뷔 이래 파격 변...	한국경제
류세비, 넘치는 건강미 [MK포토]	MK스포츠
이하늬, 내츄럴한 의상·독보적인 건강미…교토 화보	국제신문
[화보] 유인나, 음료 광고 화보서 ‘특급’ 건강미 발산	스포츠경향
레이디스코드 애슐리, 건강미 넘치는 썸머룩	조이뉴스24
[LIVE 포토]머슬마니아 안소영, 건강미 넘치는 각선미	스포티비뉴스
마마무 화사, 건강미 넘치는 구릿빛 피부	뉴스1
[포토] '체리블렛' 채린, 넘치는 건강미	스포츠서울
[포토] LG 치어리더, 건강미 넘치는 몸매	스포츠조선
[포토] LG 치어리더, 건강미 넘치는 몸매	스포츠조선
채정안, 감탄 부른 수영복 몸매 '건강미는 덤'	스포츠조선
유현주 '건강미 넘치는 몸매'[포토]	엑스포츠뉴스
이하늬 화보, 청바지만 입어도 섹시 “독보적 건강미”	서울신문
진세연, 복근이 살짝...상큼 가득 건강미 [포토뉴스]	뉴스컬처
[화보] 전소미, 운동화 모델로 건강미 발산	노컷뉴스
제시, 남다른 레깅스 패션..건강미 넘치는 뒤태	스타뉴스
[포토]EXID 하니, '감출 수 없는 건강미'	이데일리
‘섹시 디바’ 효린, 건강미 넘치는 화보	서울신문
'♥배용준' 박수진, 건강미 가득 느껴지는 사진 눈길	뉴스컬처
[N샷] '브래디 앤더슨♥' 스테파니, 브라톱+레깅스로 건강미	뉴스1
40대 머슬퀸 김소영 젊음의 비결	데일리그리드
'미우새' 한예슬, 이상형 질문에 "건강미 넘치는 타입 좋아"...김종국 어머니...	한국경제
치어리더 차영현 '건강미 넘치는 몸매'[엑's HD포토]	엑스포츠뉴스
에밀리 바우스백, 넘치는 건강미 [MK포토]	MK스포츠
건강미를 뽐낸 노예림 프로 [KLPGA 하나금융그룹 챔피언십]	골프한국
체리블렛 유주, 건강미 넘치는 미모[포토엔HD]	뉴스엔
[스경포토] [머슬마니아] 건강미	스포츠경향
신민아, 건강미 발산	이데일리
'컴백' 오마이걸, 건강미 넘치는 상큼 비주얼..개인티저 공개[Oh!쎈 컷]	OSEN
[포토] 두산 치어리더, 건강미 넘치는 몸매	스포츠조선
[화보] 설현, 건강미 넘치는 보디라인···당당한 매력 발산	서울경제
[포토] 배드키즈 '건강미 넘치는 댄스'	스포츠조선
한예슬 나이 39세…“이상형은 건강미 넘치는 스타일”	헤럴드경제
[포토] 두산 박소진, 건강미 넘치는 몸매	스포츠조선
[포토]이시영, '건강미 넘치는 그녀'	이데일리
김윤지, 밀착 운동복 위로 드러난 탄탄 복근 '건강미 과시'	스포츠한국
'독보적 분위기' 김아중, 건강미 넘치는 수영복 화보	뉴스1
[포토] 엘리스 가린 '건강미 가득한 미소'	스포츠조선
[오마이포토] 애슐리, 돋보이는 건강미	오마이뉴스
'코로나19 극복, 착한소비 촉진' 제11회 MBN건강미박람회 진행	MBN
유이, 깡마른 몸매에도 살아있는 '건강미'[★SHOT!]	OSEN
최여진의 독보적 건강미 “내 삶의 가치는 심신을 갈고 닦는 것” [화보]	TV리포트
배럴, 배럴데이 '최대 50％ 할인'..건강미 돋보이는 고준희 화보 '눈길'	한국경제
황승언, 군살 없는 탄탄한 건강미 공개	스포츠경향
'원조 썸머퀸' 효린, '바다보러갈래'로 컴백 '건강미 넘치는 섹시美' 대방출	조이뉴스24
코카콜라 ‘신체건강 W’, 유인나의 건강미 담은 TV광고 공개	컨슈머타임스
[건강미박람회] 에어닥터 공기청정기 박람회 참가	매경헬스
[포토] 임보라 '눈부신 건강미'	일간스포츠
레이양, 빨갛게 그을린 탄탄 허벅지 과시 `건강미 넘쳐`[똑똑SNS]	MK스포츠
피부관리실 에스테틱, 결+건강미+특수 관리로 효과 UP	더 기어
‘서정희 딸’ 서동주, 다이어트 근황 공개…건강미 넘치는 뒤태 [똑똑SNS]	MK스포츠
베리굿 조현, 레깅스 입고 뽑낸 건강미…"불태웠다"	MBN
건강미 넘치는 문가비	연합뉴스
[포토] 천우희, '건강미 넘치는 기립근'	한국경제
[포토] 오마이걸 반하나 '청순에 건강미 더했어요'	스포츠조선
“건강미 넘쳐” 조여정, 자기관리 끝판왕 위엄	뉴스엔
“독보적 허리라인” 설현, 화보 속 건강미 넘치는 복근	서울신문
건강미 뽐낼 수 있는 '애슬레저룩' 인기… 남성 레깅스 매출 80%↑	파이낸셜뉴스
유인나, 음료 브랜드 모델 발탁 ‘건강미 결정체’	한국경제TV
치어리더 `건강미 넘치는 비주얼` [MK포토]	MK스포츠
나르샤, 건강미 넘치는 수영복 화보 공개 '꾸준한 관리+다이어트 결과물'	스포츠서울
TWICE(트와이스) 쯔위, 건강미 넘치는 미모	웹데일리
제시, 레깅스 화보 속 탄탄한 보디 공개…건강미 '물씬'	머니투데이
[포토] 시우민 '건강미 넘치는 미소'	스포츠조선
이하늬 교토 화보, 건강미 넘치는 섹시함[포토엔]	뉴스엔
CLC 손, 건강미 넘치는 구리빛 피부 [MK포토]	MK스포츠
네이처 새봄, 건강미 넘치는 각선미 [MK포토]	MK스포츠
선미, 몸무게 8kg 증량 후 더욱 아름다워진 건강미	헤럴드POP
걸그룹 김세정은 잊어라..'경이로운 소문', 첫 촬영 치명적 걸크러시	OSEN
유인나, 뷰티 아이콘다운 건강미	뉴스엔
배우 이하늬, 건강미 넘치는 화보 공개	세계일보
롯데자이언츠 안지현 치어리더, 건강미 넘치는 일상 '설렘 유발'	뉴스컬처
오늘(8일) 'SF8' 제작보고회 등장한 이시영, 복싱으로 다져진 건강미!	위키트리
김준희, 164cm·53kg 프로필 솔직 공개하며 건강미 과시	한스경제
제시, 남다른 건강미 발산…현아도 '감탄' [★SNS]	스포츠서울
푸틴, 정교회 축제 참가해 얼음물에 목욕하며 건강미 과시	연합뉴스
한채아, 건강미 넘치는 래쉬가드 화보 공개	노컷뉴스
키썸, 컴백 위해 8kg 감량…건강미 넘치는 몸매 공개	MBN
솔비, 역시 유연성 끝판왕..탄탄 건강미의 비결	헤럴드POP
[포토] 치어리더 박소정 '건강미 넘치는 댄스'	스포츠조선
대세모델 설현, 건강미의 여신으로 변신	스포츠경향
[포토] 하지원 '건강미 발산'	스포츠조선
방탄소년단 정국 건강미 넘치는 '명품 피지컬'…스포티룩의 완성은 정국	엑스포츠뉴스
사유리, 시선 강탈 비키니 뒤태..건강미 가득 S라인	헤럴드POP
[포토]화사, 건강미의 상징	헤럴드POP
소녀시대 유리, 이탈리아서 뽐낸 건강미	노컷뉴스
건강미 과시하는 김태림	뉴시스
케이트 업튼, 건강미 가득한 트레이닝복 패션…훈훈 미모는 덤	뉴스1
‘경이로운 소문’ 김세정, 첫 촬영 공개…치명적 걸크러시	뉴스엔
배우 수현, 뷰티 브랜드 '스쿠' 첫 모델 발탁...건강미 뽐내	한국면세뉴스
'미우새' 한예슬 "건강미 넘치는 사람 좋아"…이상형 공개에 김종국母 '화색'	SBS funE
배우 김희정, SNS에 건강미 넘치는 수영복 차림 공개	스포츠경향
[건강미박람회] 종근당건강 올앳미, 이너뷰티 신제품 ‘바이탈콜라겐’ 선보여	매경헬스
최희, 군살 제로+완벽 복근…건강미 넘치는 보디 라인	마이데일리
김준희, 건강미 넘치는 운동 셀카..치명적 섹시미	헤럴드POP
배우 이하늬 독보적인 건강미의 교토 화보 공개!	국방일보
[포토S] 최은주, 감출 수 없는 건강미	스포티비뉴스
클라라, 여전한 건강미 자랑 “운동은 우리의 일기”	한스경제
한영, 건강미 넘치는 수영복 자태 공개	한스경제
'미우새' 한예슬, 母 폭발적 관심…"건강미 넘치는 남자가 이상형"	스포츠서울
[사진]KT 치어리더,'건강미 넘치는 구릿빛 피부'	OSEN
[포토]야노 시호, 건강미 발산	이데일리
설현, 오늘도 예쁨 최고치 경신 ‘청순+건강미 폭발’[포토엔]	뉴스엔
선미, 다시 찾은 건강미 [MK화보]	MK스포츠
성큼 다가온 여름, 엄현경 건강미 넘치는 화보 공개	노컷뉴스
[포토] 장여진, '건강미 물씬~'	한국경제
김세정이 근육 만든 이유, '경이로운 소문' 때문이었다…이런 모습 처음이야!	마이데일리
NS윤지, 레깅스 입고 건강미 넘치는 뒤태 자랑 [똑똑SNS]	MK스포츠
김희정, 건강미+몽환적 분위기 ‘치명적 매력 완성’[화보]	뉴스엔
손나은, '브라탑+레깅스'로 탄탄 몸매 과시…'건강미의 정석'	엑스포츠뉴스
`원조 머슬퀸` 유승옥, 건강미 넘치는 S라인 수영복 자태	매일경제
"카바디로 다진 건강미… 카바디 알리는 데 힘쓸 것"	경남매일신문
[건강미박람회]옵스킨, 흡수율 높인 먹는 콜라겐 출전	매경헬스
설현, 당당한 건강미 넘치는 화보 공개	글로벌경제
이혜영, '언빌리버블' 몸매 "건강미 넘치는 다리 미인" [★SHOT!]	OSEN
'여자 김종국' 배그린, 꿀복근 공개…탄탄한 건강미	조이뉴스24
이청아 '건강미 뿜뿜'	뉴스1
김준희, 결혼 발표 후 근황…건강미 넘치는 몸매+탄탄 복근	마이데일리
[NC포토]'허니팝콘' 미야세 나코, 반짝이는 건강미	뉴스컬처
"첫 솔로·노출·단발"…레코 애슐리, 건강미 넘치는 썸머룩	스포츠조선
[포토] 강소라, '건강미 넘치는 그녀'	한국경제
고준희, 건강미 넘치는 보디라인 [화보]	스포츠경향
치어리더 배수현, 피트니스로 가꾼 건강미 [MK포토]	MK스포츠
한혜진 "아무 걱정없는 따뜻한 봄이 오길"...건강미 '물씬'	이데일리
[BC카드·한경 레이디스컵 2020] 유현주, '건강미 넘치는 모습으로'	한국경제
[슬라이드 화보] 한채아, 애엄마 맞아?…건강미 넘치는 비키니 자태	아주경제
[포토] 문예원 '건강미 가득한 미소'	스포츠조선
AOA 설현, 청순·건강미 다 갖춘 진정한 뷰티 여신 [화보]	엑스포츠뉴스
AOA 컴백, 해상구조대 변신 '건강미 기대'	SBS funE
마마무 화사, 건강미 넘치는 수영복 자태…감탄 나오는 구릿빛 몸매	마이데일리
엄현경, 건강미 돋보이는 '컬러풀 섹시 화보'	MBC연예
채령` 건강미 넘치는 각선미` [MK포토]	MK스포츠
에바, 건강미 넘치는 초콜릿 복근 공개 "날 사랑하기"	SR타임스
고성희, 필라테스로 다져진 건강미 과시	스포츠경향
[머니S포토] 김종국 '건강미 넘치는 미소'	머니S
강소라, 건강미 넘치는 각선미 [MK포토]	MK스포츠
[Y패션] 김사랑, 골프웨어 와이드앵글 화보 공개…건강미 발산	YTN
'PMC: 더 벙커' 하정우 "이선균에겐 특유의 따뜻함-건강미 있어"(화보)	스포츠서울
"발랄한 건강미" 조보아, 자전거 라이더 변신…에너지 발산	스포츠조선
윤진서, 건강미+우아함 담은 제주도 웨딩 화보 공개	MBC연예
'경이로운 소문' 측, "러블리 김세정, 데뷔 이래 역대급 파격 변신"	enews24
[화보] 배럴걸 재발탁 고준희, 건강미 넘치는 탄탄한 바디라인 자랑	노컷뉴스
걸그룹 리브하이 출신 구보혜, 필라테스로 단련된 건강미 과시	스포츠경향
[포토] 전효성, 건강미 넘치게	매일경제
[TEN PHOTO]우도환-김설현-양세종 '건강미 넘치는 무사들'	텐아시아
걸스데이 유라, 래시가드 입고 뽐낸 건강미	노컷뉴스
유승옥, 청바지에 티셔츠만 입어도 드러나는 건강미 [★해시태그]	엑스포츠뉴스
트와이스 모모 ‘건강미 넘치는 각선미’[포토엔HD]	뉴스엔
레이디스 코드 애슐리, 콘셉트 포토 공개…건강미 과시	뉴스1
[포토]하지원, 건강미 가득한 미소	헤럴드POP
[사진]SK 배수현 치어리더,'건강미 넘치는 턴'	OSEN
몬스타엑스 원호, B컷 전격 공개..건강미 물씬[화보]	enews24
조여정, 건강미~청순미 '극과 극' 오가는 반전 매력 발산	스포츠서울
엄상미, 건강미 넘치는 구릿빛 피부 눈길	뉴스컬처
박은지, 하와이 태양 아래서 빛나는 건강미 과시	파이낸셜뉴스
설현 화보, '청순+건강미' 다 되는 뷰티 여신	enews24
이시영, 건강미 넘치는 미소 [KBS 연기대상]	MK스포츠
[건강미박람회] 시장 점유율 1위 웰킵스 마스크 할인 판매	매경헬스
마마무 화사, 건강미 넘치는 `먹방요정` [MK포토]	MK스포츠
마마무 화사, 건강미 넘치는 `먹방요정` [MK포토]	MK스포츠
`솔로 데뷔` 애슐리 건강미 넘치는 썸머룩	매일경제
문가비, 여름에 어울리는 건강미	연합뉴스
"39세 맞아?" 이효리 건강미 넘치는 근황 공개	스포츠조선
레깅스+탱크톱..정은지, 섹시한 건강미	스타뉴스
이혜영, 건강미 넘치는 수영복 자태..."49살 믿기지 않아"	텐아시아
[오마이포토] '신화' 이민우, 건강미 넘치는 하트	오마이뉴스
[N컷] 마마무, 앨범 콘셉트 사진 공개…강렬+도발 '건강미'	뉴스1
모모랜드 낸시 `건강미 과시하는 핫팬츠` [MK화보]	MK스포츠
2018 미스코리아, 진의 몸무게는?…김수민, 건강미 3종 눈길	스페셜경제
[N컷] 마마무, 앨범 콘셉트 사진 공개…강렬+도발 '건강미'	뉴스1
모모랜드 낸시 `건강미 과시하는 핫팬츠` [MK화보]	MK스포츠
2018 미스코리아, 진의 몸무게는?…김수민, 건강미 3종 눈길	스페셜경제
"드디어 첫 비행"…유이, 건강미 넘치는 미소 [★SHOT!]	OSEN
효린 지코 팔로알토, ‘효린 건강미 넘치는 갈색톤 뒤태…헉’	한국경제TV
유인영, 서핑화보 통해 건강미 과시	스포츠조선
고나은, 건강미 돋보이는 화보 공개	한국경제TV
씨스타 효린, 건강미 넘치는 근황 공개…탄탄 등근육 ‘눈길’ [스타★샷]	스포츠월드
[TEN PHOTO]선미 '건강미 넘치는 무대'	텐아시아
우에하라 아이, 건강미 가득 느껴지는 청량한 미모 화제	뉴스컬처
천이슬, 클라이밍장서도 빛나는 건강미 “오늘도 힘” [M+★SNS]	MBN
클레오 채은정, 맥심 화보서 '건강미 넘치는 섹시함' 뿜뿜!	조이뉴스24
'미우새' 한예슬 "이상형 건강미" 고백..김종국母 반색	스타뉴스
‘태양의 식후비법 W차’, 유인나의 건강미 담은 광고 B컷 공개	로이슈
오리온 치어리더 `건강미 넘치는 비주얼` [MK포토]	MK스포츠
젝시믹스 남성 라인 선봬	패션비즈
박은지, 핫써머 느낌 수영복 패션 공개…건강미 매력 눈길	RPM9
설현 '건강미 넘치는 미소'[엑's HD포토]	엑스포츠뉴스
차오루, 건강미 넘치는 몸매 비결 공개 [화보]	스포츠동아
[포토] 전혜빈, 미소에 가득찬 건강미!	스포츠조선
[포토] 전혜빈, 건강미 넘치는 각선미!	스포츠조선
아이오아이, 첫 완전체 화보…건강미 넘치는 소녀들	YTN
[건강미박람회] 크릴오일, 얼마나 좋길래?	매경헬스
양정원, 건강미 넘치는 광고 촬영 비하인드 컷 공개 '독보적 건강美'	스타데일리뉴스
[포토]WBFF, 최고의 건강미는?	이데일리
이권령, 건강미 넘치는 피트니스 선수 (인터네셔널 슈퍼퀸 광고모델 콘테스트...	시민의소리
[스경포토] [머슬마니아] 건강미를 살리는 포즈	스포츠경향
[포토] 이예진, 건강미 넘치는 미모	일간스포츠
[MD포토] 아샤 '건강미 넘치는 꿀벅지'	마이데일리
"애둘맘 화려한 변신"…김빈우, 공주풍 원피스+건강미 넘치는 미소 [★해시태...	엑스포츠뉴스
[MD포토] 아샤 '건강미 넘치는 꿀벅지'	마이데일리
"애둘맘 화려한 변신"…김빈우, 공주풍 원피스+건강미 넘치는 미소 [★해시태...	엑스포츠뉴스
MBN, 건강미 콘테스트 개최	매경헬스
이시온, 건강미 넘치는 몸매 [MK포토]	MK스포츠
탄탄한 보디라인의 건강미! 김연아, 서머 스포티룩 화보	디지틀조선일보
"건강미+섹시"...수빈, 래시가드 자태 '시선 강탈'	텐아시아
치어리더, 건강미 넘치는 각선미 [MK포토]	MK스포츠
“선명한 11자 복근...” 래시가드 입고 건강미 뽐낸 김유정	위키트리
설현, 건강미+자신감..브랜드 이미지 ‘부합’	국방일보
전효성, 넘치는 건강미 [MK포토]	MK스포츠
"건강한 몸"…야노시호, 딸 추사랑과 래시가드 입고 건강미 뿜뿜	마이데일리
'밝히는가' 신인선, 표고버섯 홍보 위해 '사랑의 버섯밭' MV 제작	헤럴드POP
서동주, 여성용품 브랜드 모델 발탁...`건강미 인증`	매일경제
효린, 언더웨어 화보서 건강미 자랑..."최근 운동량 늘려"	이데일리
[포토] SK 치어리더, 건강미 넘치는 몸매	스포츠조선
건강미 뽐내는 보디빌딩 참가자들	뉴시스
건강미 뿜뿜… 매력 발산	충청투데이
'김태희 올케' 이보미, 건강미 넘치는 분위기..♥이완 또 반할 미모까지	헤럴드POP
설리, 건강미 넘치는 에너제틱 애슬레저룩 '이 매력 대체불가'	패션엔
[포토] 브레이브걸스 하윤 '건강미 뒤태'	한국경제
[포토] 브레이브걸스 '돋보이는 건강미'	한국경제
'건강미 뿜뿜' 정은지 "운동돌이라 불러주세요" [화보]	뉴스1
[화보] 이하늬, 래쉬가드 입고 건강미 발산 '상큼'	뉴스1
오래 기억될 씨스타의 가창력과 섹시미, 건강미	헤럴드경제
홍수현, 건강미 담은 화보 공개…"겉모습 보단 내면"	머니투데이
"순수+건강미"..몬스타엑스 원호의 청량 매력[Oh!쎈 컷]	OSEN
푸틴, 정교회 축제 참가해 얼음물에 목욕하며 건강미 과시	KBS
효린 지코 팔로알토, ‘핫팬츠 입고 쩍벌…건강미 폭발’	한국경제TV
[사진] 청하 '건강미가 넘쳐'	뉴스핌
남궁민 여자친구 진아름, "덥다아~" 건강미 넘치는 일상 화제	뉴스컬처
남궁민 여자친구 진아름, "덥다아~" 건강미 넘치는 일상 화제	뉴스컬처
김혜윤, 건강미 넘치는 각선미 [청룡영화제]	MK스포츠
설리, 뽀얀 우윳빛 건강미..도발적인 포즈도 진리 [화보]	OSEN
이효리, 언더웨어 화보 공개..명불허전 건강미	이데일리
김희정, '힙'한 다이어트 티저 영상 공개…건강미 넘치는 '워너비 몸매'	엑스포츠뉴스
[건강미박람회] 현대렌탈, 미용기기 웰박스S 박람회 소개	매경헬스
[포토] 이예진, '건강미 넘치는 미소~'	한국경제
[포토] 에일리 '건강미 돋보이는 각선미'	한국경제
최희, 건강미 넘치는 몸매 공개 [★해시태그]	엑스포츠뉴스
[포토] 온앤오프 와이엇 '힘줄 불끈 건강미 자랑'	스포츠조선
[포토] AOA 혜정 '건강미 돋보이는 각선미'	한국경제
이시영, 운동으로 다진 탄탄 몸매..기럭지+건강미 독보적	헤럴드POP
'머슬퀸프로젝트' 경리, 건강미 과시 '눈길'	이데일리
베리굿 조현, 브라톱+레깅스 패션 헬스장 일상 공개..탄탄한 건강미 자랑	브레이크뉴스
김희정, 건강미 넘치는 구릿빛 피부	뉴스1
‘홀로서기’ 효린, 화장품 모델로 발탁..건강미 과시	MK스포츠
[포토Q] 김종국 '흘러넘치는 건강미'	스포츠Q
이청아 '건강미 넘치는 모습'	뉴스1
심으뜸, 레깅스 입고 뽐낸 건강미 가득 몸매 '눈길'	MBN
이하늬, 래시가드로 ‘건강미 뽐내’… 특유의 미소까지	동아일보
[포토] 엄정화, 건강미 넘치는 미소!	스포츠조선
나혼자산다 소유, 건강미 넘치는 모습 화제	한국경제TV
[사진]SK 배수현 치어리더,'건강미 넘치는 응원'	OSEN
정은지, 딱 봐도 탄탄한 팔 각선미...운동으로 완성한 건강미	헤럴드POP
조여정, 방콕서 건강미 과시하는 감각적 화보 공개!	MBC연예
[SW포토] 이하늬, 독보적 건강미	스포츠월드
[포토] 나인뮤지스A '건강미 넘치는 무대'	스포츠조선
[포토]WBFF, 건강미 뽐내는 참가자들	이데일리
[포토]김지선, 건강미의 상징	헤럴드POP
[bnt포토] 위키미키 김도연 '순백의 건강미'	bnt뉴스
이청아, 운동으로 다져진 탄탄한 몸매…넘치는 건강미	마이데일리
푸틴, 정교회 축제 참가해 얼음물에 목욕하며 건강미 과시	연합뉴스TV언론사 선정
"건강미 넘쳐"…설현, 자신감 넘치는 포즈 '매력 UP'	마이데일리
이하늬, 교토 화보 공개…독보적 건강미	스페셜경제
[스포츠경향 포토]머슬마니아 이연화, 건강미 발산	스포츠경향
'미스 마' 윤송아, 무결점 몸매로 뽐낸 건강미[화보]	헤럴드POP
'육십돌' 소녀주의보, '더유핏'과 전속 모델 '발탁'..'건강미 발산 예고'	문화뉴스
[포토] 치어리더 배수현, 넘치는 건강미	스포츠조선
[MHN포토] AOA 혜정 '건강미 넘치는 섹시미'	문화뉴스
[포토] 이미란, '건강미 여신의 우아한 자태'(2019 인터내셔널 슈퍼퀸 광고모...	뉴스프리존
[MHN포토] AOA 혜정 '건강미 넘치는 섹시미'	문화뉴스
[포토] 이미란, '건강미 여신의 우아한 자태'(2019 인터내셔널 슈퍼퀸 광고모...	뉴스프리존
[포토] 공유 '건강미 드러낸 시스루 패션'	스포츠조선
소녀시대 유리, '건강미 넘치는 자태' (공항패션)	서울경제
AOA 설현, 청순·건강미 넘치는 뷰티화보 공개 '눈길'	세계일보
[포토] 예원, 건강미 넘치는 피부!	스포츠조선
[e포토] 에버글로우, 넘치는 건강미	enews24
밴디트 송희, 건강미 넘치는 허벅지 [MK포토]	MK스포츠
꿀피부·건강미 '뿜뿜'	국방일보
[포토] ANS 달린, '건강미 뽐내는 명품 바디'	뉴스프리존
푸틴, 해발 2천m서 스키 타며 건강미 과시…"다음번엔 스노보드"	연합뉴스
성숙+청초+건강미 담은 손연재의 푸켓 화보	스포츠경향
[포토엔HD] 유승옥 ‘건강미 넘치는 각선미’	뉴스엔
[포토]김종국, 건강미 넘쳐	헤럴드POP
유이, 몸매 고민·상처 날려버린 세미누드	더팩트
[MD포토] 박은혜, '건강미 넘치는 몸매'	마이데일리
[포토] 브레이브걸스 하윤 '남심 저격 건강미'	한국경제
[MHN포토] 마마무 화사 '건강미 넘쳐~'	문화뉴스
[포토] 김희정, '건강미 넘치는 그녀~'	한국경제
소녀시대 유리, 이탈리아 화보 공개…건강미 물씬	뉴스1
소녀시대 유리, 이탈리아 화보 공개…건강미 물씬	뉴스1
모모랜드 아인 `건강미 가득한 매력` [MK화보]	MK스포츠
‘건강미+자신감’…모델따라 브랜드 이미지 UP	스포츠동아
클라라, '건강미로 가득찬 매력'	서울경제
[포토] 소녀주의보 지성, '건강미 넘치는 미모'	뉴스프리존
[화보] 평창 홍보대사 이상화, 드레스로 못 감춘 건강미	국민일보
[게임리뷰]직장인의 애환 담았네 '가우스전자'	아이뉴스24언론사 선정
‘미운우리새끼’ 한예슬 “이상형 변화, 마른 남자→건강미 넘치는 스타일”	스포츠동아
선미, 체중 증량 성공 후 50kg 인증샷 공개…건강미 UP	YTN
‘화보 장인’ 이하늬가 선보이는 기품있고 자연스러운 건강미	스포츠경향
[포토] 이하늬, 건강미 넘치는 비키니 자태 ‘시선 강탈’	서울신문
배우 강세정 요가 화보 공개 ‘건강미 물씬’	스포츠경향
장진희, 건강미 넘치는 비키니 패션…탄탄한 보디라인 공개	한국경제
10개 종목서 건강미 뽐낸 수원시	경인일보
[건강미박람회] '칼로리 제로', 건강음료 보이조아ㆍ레몬보이	매경헬스
[MD포토] 모델 조애라, '건강미 가득하죠'	마이데일리
[MD포토] 모델 원지민, '건강미 가득'	마이데일리
[오마이포토] AOA 유나, 초여름 흔들 건강미	오마이뉴스
'크롭녀' 전보람, 건강미 넘치는 콜라병 몸매 화제	뉴스컬처
[bnt포토] 리아킴 '넘치는 건강미'	bnt뉴스
'나 혼자 산다' 성훈, 철인 3종 대회에서 전체 5위, 수영 1위 등극! '건강미'...	MBC연예
클라라, 건강미 철철 비현실적인 호리병 몸매	매일경제
강예원 `감출 수 없는 건강미` [MBN포토]	MBN
'야구여신' 최희, 건강미 넘치는 요가 화보 공개	스포츠서울
[포토] 씨스타 '건강미 돋보이는 각선미'	한국경제
배우 하지원, 푸르밀 팬사인회 참석 '부산팬 홀린 건강미' 과시	경상일보
효연 `건강미 넘치는 몸매` [MK포토]	MK스포츠
혜정 ‘건강미 넘치는 미모’(sbs연기대상)[포토엔HD]	뉴스엔
세리박스, 강소라의 건강미 비결 CF에서 공개	뉴스컬처
한예슬 “이상형, 건강미 넘치는 분”…김종국 母 “아들한테 전화 해야겠다”...	MBN
이하늬, 건강미 넘치는 수영복 자태 '눈길'	월요신문
효민, 골프웨어도 완벽 소화…건강미 넘치는 몸매	마이데일리
[포토] AOA 혜정 '건강미 돋보이는 각선미'	한국경제
소유, 발리서 뽐낸 수영복 자태…건강미 '물씬'	머니투데이
[포토] 조정민 '건강미 돋보이는 미소'	한국경제
[포토] 카라 박규리 '돋보이는 건강미'	한국경제
유리, 등산 인증샷 공개...건강미 넘치는 모습[★해시태그]	엑스포츠뉴스
이효리, 여전히 건강미 넘치는 뒤태 과시 ‘매혹’ (화보)	MBN
[포토] 안현모 '라이머가 반한 건강미'	일간스포츠
[포토엔HD] 김준현 ‘건강미의 대명사’(바람 바람 바람)	뉴스엔
[포토] 이예진, '건강미 넘치는 포즈'(머슬마니아 화보)	뉴스프리존
AOA 설현, 건강미 넘치는 모델 화보로 "봄소식 알리다"	세계일보
이하늬, `건강미 넘쳐~` [MBN포토]	MBN
‘아이언 레이디’ 윤소희, 운동 중인 모습 포착…건강미 넘치는 자태	동아일보
손태영, 건강미 넘치는 뒤태…남편 권상우 반할 수 밖에 [똑똑SNS]	MK스포츠
신수지 '역대급 건강미' 화보컷 '스포티+관능美' 폭발	스포츠조선
임다연, 수영선수의 뒷태란? 탄탄한 건강미 "눈길"	데일리한국
[포토] 건강미 넘치는 한혜진	매일경제
솔비 근황, 논란 종결 '볼륨감-탄탄 복근' 과시…'건강미 철철'	스포츠서울
[포토] 에일리 '건강미 넘치게'	스포츠조선
'서머 퀸' 애슐리 "차별화된 매력? 건강미 더한 섹시"	뉴스1
요가 강사 박초롱, 이연희 닮은꼴 입이 쩍…건강미도 돋보이네	스포츠서울
‘새 로드걸’ 이서현, 섹시·건강미로 男心 올킬 예약?	국민일보
[포토] 원지민, 시선 사로잡는 건강미	시사포커스
트레일러너들 강릉서 건강미 뽐내	뉴시스
이효리, 개미허리+황금골반 자랑..푸마와 건강미 넘치는 화보	뉴스인사이드
[스포츠경향 포토]머슬마니아 김지영, 느껴지는 건강미	스포츠경향
[MD포토] 안희연, '건강미 넘치는 각선미'	마이데일리
이시영, 독보적 건강미…등산복 입고 군살제로 몸매 자랑	헤럴드POP
"11자 복근X각선미"…가희, 넘치는 건강미 [화보]	스포츠조선
[MD포토] 안희연, '건강미 넘치는 각선미'	마이데일리
이시영, 독보적 건강미…등산복 입고 군살제로 몸매 자랑	헤럴드POP
"11자 복근X각선미"…가희, 넘치는 건강미 [화보]	스포츠조선
"청순미보다 건강미"…운동기구 찾는 여성 늘어	연합뉴스
[포토]씨스타, 비키니 뒤태 '건강미 넘쳐'	이데일리
[건강미박람회] 티젠 콤부차, 유산균으로 여름철 면역력 뿜뿜	매경헬스
유빈, 래쉬가드 화보로 드러난 섹시+건강미[화보]	스포츠조선
[포토] 있지 리아 '핫 팬츠에 건강미 발산'	스포츠조선
[포토] 브레이브걸스 '건강미 넘치는 매력'	스포츠조선
조여정, 건강미 돋보이는 화보 공개 ‘자기관리 끝판왕’	동아일보
조여정, 건강미 돋보이는 화보 공개 ‘자기관리 끝판왕’	동아일보
샬롯 구찌, 건강미 넘치는 보디라인‘플래시댄스’[포토엔HD]	뉴스엔
[포토] 치어리더 배수현 '건강미 물씬'	스포츠서울
씨엘, 살쪘다고? 美 할리우드 배우들과..섹시한 건강미	스타뉴스
[포토] AOA '건강미 넘치는 구조대 컨셉'	스포츠조선
[포토] 치어리더 배수현, 건강미 넘치는 구리빛	스포츠조선
건강미 뽐내는 참가자들	뉴스1
아이즈원 김민주, 건강미 넘치는 미모	스포츠한국
한채아, 스포츠 여신도 꿰찼다…독보적인 건강미	스포츠동아
건강미 뽐낸 창원시립곰두리 직원·회원	경남도민일보
가희, 건강미 넘치는 일상샷 ‘우월한 미모는 덤’	뉴스컬처
[T포토] 선샤인 '건강미 넘쳐'	TV리포트
[포토] 브레이브걸스 유정 '건강미 돋보이는 의상'	한국경제
유이, 고난도 필라테스 동작으로 '건강미' 넘치는 근황 전해	아시아경제
클라라의 몸매, 호리병에 담은 건강미…‘저 높은 곳을 향하여’	스포츠경향
이하늬, 여름 해변에서…건강미 넘치는 수영복 화보	매일경제
"출산 3개월만의 복귀"…장윤주, 명불허전 건강미	스포츠조선
[포토] ITZY 채령 '탄탄한 건강미 복근'	스포츠조선
‘섹시 디바’ 효린, 볼륨 넘치는 건강미 [화보]	매일경제
[SS포토]전효성, 건강미 포즈는 이 정도로	스포츠서울
김빈우, 크롭탑+핫팬츠 입고 뽐낸 늘씬 몸매…건강미 물씬	마이데일리
‘천송이’ 전지현, 몸에 딱 붙는 아웃도어로 늘씬 건강미 과시	동아일보
아이오아이, 첫 완전체 화보 공개..넘치는 건강미 과시	전자신문
고준희, 돋보이는 건강미 [화보]	엑스포츠뉴스
AOA, 해상구조대 완벽 변신 영상…건강미-섹시 보디라인	스포츠동아
프로스펙스, 모모랜드 화보 비하인드컷 공개 "건강미 뿜뿜"	뉴스1
배우 이엘, 피트니스 화보 ‘넘치는 건강미’	뉴스1
[e포토] 체리블렛, 넘치는 건강미	enews24
한보름, 건강미 넘치는 보디라인 "비하인드컷도 완벽" (화보)	스포츠서울
고준희, 건강미 넘치는 수영복 자태 '명품 복근' [화보]	엑스포츠뉴스
[포토] 씨스타 효린 '건강미 돋보이는 구리빛 피부'	한국경제
마마무 휘인, 건강미 넘치는 각선미 [2018 코리아 뮤직 페스티벌]	MK스포츠
[건강미박람회] 멘탈닥터, 두뇌 컨디션 측정이 가능한 이지밸런스	매경헬스
[건강미박람회] 안다르, 에어쿨링 레깅스 출품 ...자외선 차단 99.9%	매경헬스
[오마이포토] AOA 초아, 성숙미와 건강미의 조화	오마이뉴스
선미, 8kg 증량으로 건강미 과시 "마른 몸매 걱정 NO" [종합]	엑스포츠뉴스
[포토]씨스타 효린, 건강미 발산	이데일리
설현의 건강미	연합뉴스
[화보] 황승언, 시선 싹쓸이한 ‘넘사벽 건강미’	스포츠경향
문근영 근황, 건강미 뽐내며 팬클럽 3주년 `자축`	매일경제
이영서, `건강미 철철` [MK포토]	MK스포츠
[포토] 씨스타 소유 '시선 사로잡는 건강미'	한국경제
조여정, 방콕서 건강미 뽐내..떠나고 싶게 만드는 화보 공개	이데일리
이엘, 탄탄한 보디라인과 완벽한 S라인 ‘건강미 눈길’	동아일보
클라라, 복근 드러내며 탄탄한 건강미 자랑…양갈래 머리 발랄 매력도	스포츠한국
가희 `건강미 넘치네` [MBN포토]	MBN
이시영, 운동으로 완성한 극세사 몸매..'탄탄 건강미'[★SHOT!]	OSEN
류 쿠마가이, 해변보다 빛나는 비키니 자태…‘넘치는 건강미’	헤럴드경제
[포토] 씨엘씨 손 '건강미 돋보이는 각선미'	한국경제
선미, 체중 증량 후 넘치는 건강미..자신감 가득	스타뉴스
[N화보] 채정안의 건강미…"사진에 주름 나오는 것 두렵지 않아"	뉴스1
눈이 정화..하정우x이선균 투 샷, “이선균 따뜻함-건강미 있는 배우”	bnt뉴스
[포토]윤진서, 건강미 넘치는 서핑룩	이데일리
[화보] 이하늬, 건강미 넘치는 래쉬가드 자태	스포츠경향
"독보적 섹시함"…효린, 건강미 넘치는 매력[화보]	헤럴드POP
'마리텔V2' 마마무 솔라, 건강미 넘치는 폴댄스→갑자기 분위기 먹방?	OSEN
[포착]피트니스 건강미 끝판왕	국민일보
'8kg증량' 선미, 50kg 몸무게 인증…'눈에 띄는 건강미' [SNS컷]	스포티비뉴스
에프엑스 루나, 밀착 원피스로 건강미 과시 '남다른 옆태'	마이데일리
[포토] 베스티 혜연 '건강미 돋보이는 뒤태'	한국경제
선미, 건강미 넘치는 근황..."운동이 너무 재밌어"	뉴스컬처
손나은 근황, 개미 허리 드러내고 건강미 발산 ‘오늘도 예쁨’ [똑똑SNS]	MK스포츠
유이, 되찾은 건강미…리즈는 지금 [화보]	티브이데일리
[포토] 제니퍼 로렌스 '추위 잊게 만드는 건강미'	스포츠조선
마마무 화사, 건강미 넘치는 구릿빛 피부	뉴스1
[HI★포토] 구릿빛 김다솜, 물오른 건강미	한국일보
[포토] 김예림 '건강미 돋보이는 각선미'	한국경제
[포토] 유승옥, '청순-건강미'	스포츠조선
이엘, 건강미 넘치는 피트니스룩 화보 공개	디지털타임스
김정민, 아름다운 복근 드러내며 건강미 과시 [화보]	스포츠동아
[포토]요가-필라테스 강사 신한빛, 건강미의 끝판왕	STN 스포츠
"건강미의 정석"…효린, 구릿빛 S라인	스포츠조선
씨스타 팬 사인회, 킬힐 벗고 건강미 뽐내	뉴스1
요가 강사 박초롱, 건강미 아이콘 등극?…배우 이연희 닮아 화제	스포츠서울
레이양, 여름 화보로 건강미 과시	노컷뉴스
김소은, 건강미 넘치는 섹시 몸매	서울신문
[스포츠경향 포토]머슬마니아 강연지, 뙤약볕 아래 건강미	스포츠경향
한채아, 래쉬가드 입고 ‘슬림탄탄’ 건강미 과시	스포츠경향
[포토]머슬마니아 전혜빈, 건강미의 끝판왕	한국경제TV
건강미 뽐내는 보디빌더	연합뉴스
[포토]머슬마니아 전혜빈, 건강미의 끝판왕	한국경제TV
건강미 뽐내는 보디빌더	연합뉴스
[오마이포토] '케이월드 페스타' CLC 장승연, 돋보이는 건강미	오마이뉴스
코카-콜라사, 유인나 건강미 담은 ‘신체건강 W' TV 광고 공개	글로벌경제
로드걸 이서현 발탁…“건강미, 섹시 등 다양한 매력 발산하겠다”	MBN
마마무 화사, 해변위에 건강미 뽐내	세계일보
[ST포토] 인주연, 건강미!	스포츠투데이
이일화, ?탄탄한 복근 자랑하며 20대 능가하는 건강미 뽐내	한국경제TV
[포토] 브레이브걸스 하윤 '건강미 넘치는 막내'	스포츠조선
조여정, 군살 하나 없는 ‘탄탄한 건강미’ 과시	스포츠경향
현영, 골프 치는 중 건강미 넘치는 몸매 "추억팔이"	헤럴드POP
유인영, 서핑 화보.. 숨겨왔던 건강미 과시	이데일리
미쓰에이 지아, JYP 떠나기전 마지막 화보 촬영? '탄력 건강미'	스포츠조선
헬로비너스 헬스장 건강미 6인6색	국방일보
백아연 ‘배꼽 드러낸 건강미’ [포토엔HD]	뉴스엔
[포토] AOA 초아 '건강미 발산하는 각선미'	스포츠조선
효린, 홀러서기 후 첫 화장품 브랜드 모델 발탁...천연 건강미 발산	텐아시아
[스타패션] 이하늬, 대체불가 건강미…해변의 여신으로 변신	스포츠경향
“역시 화보장인!”...이하늬, 수영복 화보로 건강미 발산	스포츠서울
김세정 스틸, 폭발적 걸크러시 매력 "데뷔 이래 역대급 파격 변신"	미디어펜
씨스타, 건강미 넘치는 비치 화보 공개 '아찔 볼륨 자태'	스포츠조선
윤진서, 제주도 리얼 라이프 화보 '건강미 가득'	뉴스1
유리 `건강미 넘치는 꽃 미소` [MBN포토]	MBN
[포토]소이현, 건강미 넘치는 예비맘 '12월에 엄마 돼요'	이데일리
김윤지(NS윤지), 여성들 ‘워너비’다운 건강미 넘치는 매력 200% 발산	브레이크뉴스
보라 `건강미 넘치는 무대` [MBN포토]	MBN
미나, '건강미 뽐내며'	서울경제
아이돌 新 키워드는 ‘스포츠’, 엑소 이어 AOA도 ‘건강미’로 승부	문화일보
[포토] `섹시백`은 건강미에요!	매일경제
함소원, 건강미 넘치는 완벽몸매…"거창하게 운동 안 하셔도 돼요"	뉴스인사이드
소녀주의보 지성 "60kg 화제 당황…건강미 유지하겠다"	매일경제
이시영 '건강미 넘치는 미소'[엑's HD포토]	엑스포츠뉴스
[화보] 보라-효연-모모 `건강미 대결 승자는?`	MBN
[포토] 씨스타 효린 '섹시한 건강미 발산'	스포츠조선
[포토]김재경, 사이판서 독보적인 건강미	이데일리
"신비로운 분위기" 배그린, 청량한 건강미(화보)	뉴스컬처
[포토] 걸스데이 유라 '건강미 돋보이는 각선미'	한국경제
유빈, 건강미美+청순美가 공존하는 팔색조 매력 [화보]	OSEN
나바코리아 `건강미 넘치는 뒤태` [MK포토]	MK스포츠
[포토] 나인뮤지스 경리 '건강미 돋보이는 각선미'	한국경제
조여정, 광고 비하인드컷 속 건강미 vs 청순미 '반전 매력' 발산	매일신문
[MD포토] 류세비 '당당한 건강미'	마이데일리
박결 `건강미 넘치는 패션` [MK포토]	MK스포츠
[포토] 박보람, 건강미 넘치는 당근 소녀!	스포츠조선
'부부의 세계' 한소희, 스포츠웨어 뮤즈 발탁…건강미 물씬	미디어펜
러블리즈 지수, 유연성 끝판왕..필라테스로 뽐낸 건강미	헤럴드POP
I.O.I, 첫 화보 촬영..건강미 넘치는 스포티한 매력 ‘취향 저격’	한국경제
이하늬, 건강미 넘치는 래시가드 화보 '시선강탈'	스포츠서울
"몸매 이 정도였어?"…소녀시대 최수영, 언더웨어 화보 '건강미 발산'	마이데일리
AOA 설현, 탄탄 보디라인으로 건강미 과시	스포츠조선
[MD포토] 박준형 '건강미 넘치는 구릿빛 피부'	마이데일리
[포토] 나나, 건강미 뽐내	이데일리
[건강미박람회] 스마트 헬스케어 기업 대거 참가...플로우7 마사지건	매경헬스
[TD영상] 조여정 ‘레드카펫을 물들인 건강미’	티브이데일리
한그루 화보, 건강미 넘치는 관능미 ‘정말 예뻐’	MBN
건강미 뽐내는 참가자들	뉴시스
브레이브걸스 컴백, 밀착 의상 입고 남다른 건강미 발산 “변했어”	전자신문
에일리 `건강미 넘치는 무보정 각선미` [MBN포토]	MBN
[포토] 씨스타 '건강미 넘치는 각선미'	한국경제
이엘, 건강미 넘치는 무결점 몸매로 시선 강탈	부산일보
이엘, 건강미 넘치는 무결점 몸매로 시선 강탈	부산일보
유승옥, `감출수 없는 건강미` [MK포토]	MK스포츠
소유, 섹시한 건강미 뽐내며 수상스키 '男회원 탄성'	스포츠조선
소유 `건강미 넘치는 뒤태` [MBN포토]	MBN
"유지가 더 어려워"…에바, 건강미 넘치는 탄탄한 몸매	마이데일리
[포토]머슬마니아 모델 김시아, 건강미의 대명사	한국경제TV
[문화포토] 임솔아 '건강미 넘치는 미소'(지스타2017)	문화뉴스
설현 뷰티헬스케어 모델 발탁, “건강미+자신감”	마이데일리
치어리더 김연정 "건강미 넘치는 콘셉트의 화보 찍고 싶어"	엠스플뉴스
[화보] "청량감 톡톡"…AOA, 6인6색 건강미+청순 매력	마이데일리
[화보] "청량감 톡톡"…AOA, 6인6색 건강미+청순 매력	마이데일리
레인보우 오승아 `건강미 넘치네` [MBN포토]	MBN
[포토] 수지 '변함 없는 건강미 과시'	스포츠조선
달샤벳, 건강미 넘치는 볼륨몸매로 남심저격! [화보]	스포츠조선
"철저한 자기관리"…효린, 남다른 건강미	헤럴드POP
체리블렛 채린, `매력적인 건강미` [스타포토]	디지털타임스
정다래, '건강미 넘치는 자태' (인천공항 출국)	서울경제
[오마이포토] EXID 하니, 돋보이는 건강미	오마이뉴스
[MD포토] 유현주 '건강미 넘치는 몸매'	마이데일리
"완벽한 바디라인"…조여정, 건강미·청순미 오가는 반전 매력	마이데일리
[포토] 김은정, 건강미 물씬	스포츠서울
김도연, 건강미 넘치는 포즈! (위키미키 쇼케이스)	서울경제
씨스타 소유 `건강미 넘쳐~` [MBN포토]	MBN
AOA, ‘굿 럭’ 위크 버전 티저 영상 공개…건강미-섹시 보디라인	한국경제TV
[포토] 씨스타 '통통 튀는 건강미'	스포츠조선
진세연, ‘섹시+건강미’ 넘치는 매력 발산	한국경제TV
나다 “현아와 난 다른 섹시함, 여성미보다 건강미”	헤럴드경제
[스포츠경향 포토]머슬마니아 이연화, 새로운 머슬 퀸의 건강미	스포츠경향
유빈 `건강미 가득` [MK포토]	MK스포츠
[포토] 멜로디데이 예인 '건강미 돋보이는 각선미'	한국경제
오정연, 건강미 넘치는 비주얼[포토엔HD]	뉴스엔
[사진]치어리더 이나경, '건강미 뽐내며'	OSEN
효린 꽃게춤 한때는 건강미의 상징…달리 춤사위와 견줄만한 민망함	일간리더스경제
류효영, 볼륨감+건강미...아찔한 수영복 자태	텐아시아
[TEN PHOTO] 최희서 '건강미 넘치는 미모'	텐아시아
NS윤지, 건강미 넘치는 비주얼…딱 달라붙는 레깅스에도 굴욕無	헤럴드POP
[MD포토] 있지 채령, '건강미 넘치는 각선미'	마이데일리
[포토]이연의 구릿빛 피부 '섹시+건강미'	이데일리
[포토] 에이코어 '건강미 돋보이는 각선미'	한국경제
안지혜 '건강미 전파하는 현주'	연합뉴스
아이오아이(I.O.I), 첫 완전체 화보 공개…건강미 넘치는 여성미	한국경제TV
다솜 `시선 사로잡는 건강미` [MBN포토]	MBN
고흥 ‘수호천사건강미’ 6년 연속 전남 10대 브랜드쌀 선정	프레시안
'미워도 사랑해' 표예진, 건강미 물씬[SS포토]	스포츠서울
[사진]블랙핑크 로제,'돋보이는 건강미'	OSEN
한지안, 건강미 가득 (인터뷰 포토)	서울경제
소녀주의보 지성, 광고계 러브콜 “60kg 건강미 적합”	뉴스엔
마이23헬스케어, ‘살금교환 프로젝트’, 체중 5% 빼면 순금 준다	빅데이터뉴스
[포토] 브레이브걸스 혜란 '건강미 돋보이는 스쿼트 자세'	한국경제
‘컴백’ 에이프릴 채원X레이첼X진솔, 건강미 섹시미 물씬	뉴스엔
한예슬 '여전히' 매력만점 건강미 과시, 화보 통해 근황 공개	스포츠조선
나인뮤지스, 건강미 가득 비치룩 개인컷 공개 '모델돌 위엄'	텐아시아
[사진]CLC 장승연,'건강미 넘치는 섹시함'	OSEN
김옥빈, 운동복 입고 뽐낸 건강미 “먹을 땐 좋았죠”[SNS★컷]	뉴스엔
하니 `건강미 넘치는 각선미` [MBN포토]	MBN
'비행소녀' 최여진, 암 예방 홍보 캠페인에서도 '건강미 뿜뿜'	서울경제
제시, 건강미 넘치는 외모!	서울경제
클라라, VOV 모델로 섹시 건강미 또 입증!	스포츠조선
[포토] 밍스 '건강미 넘치는 모습으로~'	스포츠조선
여민지, `더욱 샤프해진 건강미` [MK포토]	MK스포츠
[포토]루나, 건강미 넘치네!	헤럴드POP
[스포츠경향 포토]‘머슬마니아’ 남다른 건강미	스포츠경향
이시영, 건강미 넘치는 운동홀릭 근황..."오늘은 청계산"	인천일보
유현주 '건강미 넘치는 몸매'[포토]	엑스포츠뉴스
[포토] 씨스타 '복근에 허벅지에~ 건강미 폭발'	스포츠조선
"이것이 건강미"…이하늬, 수영복 화보서 뽐낸 바디라인	마이데일리
[포토] 정아름 '돋보이는 건강미'	한국경제
[포토] 김희정, '건강미 넘치는 모습에 눈길~'	한국경제
[포토] 소나무 민재 '건강미 돋보이는 각선미'	한국경제
있지 채령, 건강미 넘치는 섹시복근 [MK포토]	MK스포츠
소녀주의보, 건강미 가득 (쇼케이스)	서울경제
강소연의 도발, 건강미 넘치는 수영복 화보	매일경제
[포토]건강미와 섹시미를 동시에	헤럴드POP
나다, 화보 공개 '건강미 발산'	이데일리
"이 비주얼 실화"…이효리, 건강미 교과서 [화보]	스포츠조선
[포토] 씨스타 소유 '운동으로 건강미 넘치는 각선미'	한국경제
‘원조 스트롱맨’ 푸틴 해발2천m서 스키로 건강미 과시	브릿지경제
[사진]문가비-김예림,'섹시한 건강미 대결'	OSEN
소녀시대 유리, 등산으로 가꾼 건강미	TV리포트
[포토] 걸스데이 소진 '건강미 돋보이는 각선미'	한국경제
현아, 은근히 드러낸 복근으로 건강미 'UP'	부산일보
[포토]머슬마니아 오다은, 건강미의 대명사	한국경제TV
건강미 甲…60kg 중에 제일 예뻐, 소녀주의보 지성	한국경제
소유, 인도양 모리셔스 화보..백사자와 함께 '독보적 건강미'	스타뉴스
이하늬, 롱패딩으로도 가릴 수 없는 독보적인 건강미 [화보]	스포츠동아
채정안, 건강미 넘치는 구리빛 미모[포토엔HD]	뉴스엔
조보아, '건강미 넘치는 자태' (팬사인회)	서울경제
[포토]건강미 넘치는 AOA 설현	헤럴드POP
오정연 아나운서 살 쪘을 때 모습… 건강미 오히려 보기 좋네	국제신문
‘배틀트립’ 조보아, ‘탄탄 건강미+무더위 날리는 시원미소’ 시선강탈	한국경제TV
"워너비 S라인"…효린, K팝 디바의 건강미	스포츠조선
유현주 '건강미 넘치는 몸매 뽐내며'[포토]	엑스포츠뉴스
2020 KLPGA 복귀 앞둔 유현주 프로, 건강미 넘치는 화보 공개	머니S
[포토S] 임진영 SPOFIT 심사위원, 건강미 뽐내며	스포티비뉴스
'나혼자 산다' 박나래, 홍현희·미주와 건강미 다이어트…빅재미 예고	TV리포트
안다르, 2020 F/W 신제품과 함께 마마무 화보 공개	이데일리
[포토뉴스] 김정화, '건강미 넘치는 매력~!' (쎄라퀀비키니쇼 어워즈)	뉴스타운
해상구조대로 돌아온 AOA, 실루엣만 봐도 놀라운 건강미	헤럴드POP
'아이언 레이디' 윤소희, 건강미 뽐내며 운동…걸크러쉬 매력폭발	스포츠조선
[포토] 구하라, 발리 화보서 섹시+건강미 발산	이데일리
'아찔 뒤태 자랑'…카라 니콜, 건강미 넘치는 비키니 핏	마이데일리
로드걸 최설화 `시선 싹쓸이한 건강미` [MK포토]	MK스포츠
[포토] 우주소녀 연정 '건강미 발산'	스포츠조선
[포토] 쯔위, '건강미 물씬'	세계일보
태진아, 평창 동계올림픽 성화봉 인증사진 공개 '건강미 물씬'	한국일보
이재윤, `넘치는 건강미~` [MBN포토]	MBN
씨스타 `건강미 넘치는 섹시` [MBN포토]	MBN
이승신 나이? 한결 같은 건강미 유지할 수 있는 비결은?	넥스트데일리
[포토]아디다스 매료시킨 효린, 건강미와 섹시 사이	이데일리
김윤지, 수영복 입고 건강미 물씬 '물오른 미모' [★SNS]	스포츠서울
마동석 ‘건강미 넘치는 어깨’ [포토엔HD]	뉴스엔
유이 '정글의 법칙' 합류…'건강미'로 홍일점 활약상 기대	한국경제TV
[MHN포토] 마마무 화사 '건강미 넘치는 섹시~'(가요대전)	문화뉴스
소유 '흘러넘치는 건강미'[엑's HD포토]	엑스포츠뉴스
[경향포토]브레이브걸스, 머슬퀸으로 노출아닌 건강미	경향신문
황승언, 테니스 코트서 ‘넘사벽’ 건강미 발산	스포츠경향
[E포토]건강미 넘치는 AOA 초아	SBS funE
[스포츠경향 포토]AOA, 건강미의 여신으로	스포츠경향
[포토] 카라 박규리, 건강미 넘치는 모습!	스포츠조선
'60kg 아이돌' 소녀주의보, ‘더유핏’ 모델 발탁..건강미 '뿜뿜'	중도일보
`단발여신` 고준희 수영복 화보…건강미 넘치는 명품 복근 ‘눈길’	매일경제
[TEN포토] 머슬퀸 이예진 '건강미 넘치는 하트'	텐아시아
선미, 8kg 증량 건강미↑→8월 말 자작곡 컴백..5연타 흥행 이어갈까 [종합]	OSEN
[포토] AOA 유나 '건강미 발산한 초미니'	스포츠조선
[사진]체리블렛 레미, '건강미 뽐내며'	OSEN
소나무, 섹시미부터 건강미까지...7인 7색 티저 이미지 '눈길'	스포츠조선
[포토]이장숙, '섹시한 건강미'	이데일리
빅토리아 베컴, 파격 화보…건강미 돋보여	스포츠동아
브레이브걸스, 컴백 콘셉트는 ‘머슬퀸’…건강미+섹시미	스포츠동아
크리샤츄, 섹시미+건강미…거침없는 매력 발산	이데일리
크리샤츄, 섹시미+건강미…거침없는 매력 발산	이데일리
소나무 디에나 `건강미 넘쳐` [MBN포토]	MBN
마마무 문별 `건강미 넘치는 각선미` [MBN포토]	MBN
알리시아 비칸데르, 건강미 넘치는 구리빛 [MK포토]	MK스포츠
"톱모델의 위엄" 한혜진,언더웨어화보서 시크한 건강미	스포츠서울
[bnt포토] 김정화 '건강미 넘치는 구릿빛 피부'	bnt뉴스
[오마이포토] 전혜빈, 돋보이는 건강미	오마이뉴스
'60kg 걸그룹' 소녀주의보, 건강미·복지돌 앞세워 1년만 컴백 (종합)	마이데일리
‘건강미 뿜뿜’ 고성희, 운동복 화보 “많은 모습 보여주고파”	뉴스1
[포토] 씨엘씨 손 '건강미 넘치는 각선미'	한국경제
"탱크톱+레깅스도 찰떡"…블랙핑크 제니, 폭포 아래서 뽐낸 건강미	마이데일리
한예슬 , 힙한드레스코드 번쩍, 건강미 철철	인천뉴스
[포토]'오인혜, 건강미 넘치는 모습'	이데일리
효연 `건강미 넘치는 보디라인` [MBN포토]	MBN
조보아, 건강미 넘치는 취미 공개 [★해시태그]	엑스포츠뉴스
[포토] 건강미 철철.. 진짜 센 언니	이데일리
[스포츠경향 포토]김지민, 머슬마니아 그랑프리 수상자의 건강미	스포츠경향
[엑's HD] 위키미키 김도연 '넘치는 건강미'	엑스포츠뉴스
[포토] 에일리 '시스루로 돋보이는 건강미'	한국경제
토니모리, 제시와 함께한 속눈썹 부캐 컬렉션 화보 공개	데일리그리드
[포토] 브레이브걸스 '건강미 물씬 풍기는 요가 팬츠'	스포츠조선
[오색인문학] 150년전 박해 피해온 신자들 염원 간직한 '성당 지킴이'	서울경제
[SS포토] 멜론뮤직어워드, 효린 '건강미 넘치는 미소'	스포츠서울
씨스타 효린 건강미 넘치는 오키나와 화보	스포츠서울
흑진주 유리, 건강미 넘치는 수영복 화보[포토엔]	뉴스엔
[포토] 나인뮤지스 경리 '건강미 돋보이는 각선미'	한국경제
‘여왕의 귀환’ 이효리, 건강미 넘치는 애슬레저 룩 화보 공개	동아일보
장윤주, 비오템 모델 발탁 '건강미 발산'	이데일리
[포토] 에버글로우 이유 '건강미 가득한 무대'	스포츠조선
이엘 화보 ‘도깨비’ 삼신할매는 어디에? ‘건강미 넘치는 섹시’	서울신문
[N1★화보]정용화, 하와이서 그을린 피부로 매력 발산 '건강미'	뉴스1
"스물넷, 예뻐졌다"…박보람, 반짝이는 건강미 [화보]	스포츠조선
[포토] 나인뮤지스 경리 '건강미가 느껴지죠?'	스포츠조선
배우 성훈, 건강미와 신선함으로 글로우라우디 샴푸 모델 발탁	한국경제
[포토] 건강미 넘치는 63세 머슬퀸 장래오	디지털타임스
[bnt화보] 나다 “현아와 난 다른 섹시함, 여성미보다 건강미”	bnt뉴스
이시영, 건강미 넘치는 몸매 뒤 고충 "요즘 막연히 운동 싫다"	헤럴드POP
[포토] 머슬마니아 이성현, 단단한 건강미	디지털타임스
'경이로운 소문' 김세정, 첫 스틸 공개.. 러블리 지우는 '치명 걸크러시' 폭발	스타데일리뉴스
[포토] 마마무 화사 '건강미 돋보이는 각선미'	한국경제
[포토] 마마무 화사 '건강미 돋보이는 각선미'	한국경제
이시영, 꽃샘 추위에도 반팔 패션..'운동으로 다진 건강미'[★SHOT!]	OSEN
발레리나 강수진, 범접할 수 없는 아우라&건강미 [화보]	스포츠동아
이나경, 건강미 넘치는 각선미 [MK포토]	MK스포츠
"나 살 탄 것 좀 봐요"..경리, 건강미 더한 고양이상 예쁨	헤럴드POP
스테파니, 건강미 삼킨 피부미녀라 불러다오 [화보]	스포츠동아
[포토]함은정, 건강미 넘치는 바디라인 '놀라워'	이데일리
바바, `건강미 넘쳐` [MBN포토]	MBN
건강미 넘치는 신민아 패션지 화보 ‘실망시키지 않아’	스포츠경향
'솔로 출격' 레이디스코드 애슐리, 뜨거운 여름 속 '건강미' 발산	엑스포츠뉴스
[Oh!쎈 레터] 김혜선, 건강미 개그우먼→독일 유학→독일인과 가을결혼	OSEN
[포토]신수지 '건강미가 곧 섹시미'	이데일리
신세경, 건강미 넘치는 애슬릿룩 '눈길'	서울경제
나비, 발리서 건강미 넘치는 몸매…"두 달 동안 9kg 감량"	매일경제
제시 '건강미 넘치는 구릿빛 피부'[엑's HD포토]	엑스포츠뉴스
[포토] 문채원, '건강미 넘치는 매력 눈길'	스포츠조선
애슐리 '건강미 물씬~'	스포츠한국
'미우새' 한예슬 "나이 먹다 보니까 건강미 넘치는 男 좋아"…'몇살?'	스포츠한국
조여정, 광고 비하인드컷 '건강미 발산'	이데일리
‘핫보디’ 소유, 건강미 넘치는 모습	서울신문
‘핫보디’ 소유, 건강미 넘치는 모습	서울신문
'컴백' AOA, 설현 '건강미 발산'	이데일리
'넘치는 건강미'	뉴스1
김지혜, 유연성 뽐내는 요가 인증샷 공개…건강미 뿜뿜 [★해시태그]	엑스포츠뉴스
[포토] 원더걸스 유빈 '건강미 돋보이는 각선미'	한국경제
이시영, 절친 소유진과 등산..건강미 넘치는 늘씬 몸매 '감탄'	헤럴드POP
이하늬, 비치웨어 모델 발탁 '건강미 물씬' [화보]	엑스포츠뉴스
에바, 헬스트레이너 뺨치는 복근 공개 ‘건강미 발산’‘[SNS★컷]	뉴스엔
블랙핑크·우도환, 스프라이트 화보 속 '건강미' 물씬	머니투데이
[포토] '걷기왕' 심은경, 경보로 다져진 건강미!	스포츠조선
한영, 건강미 넘치는 수영복 자태 '개미허리 감탄'	데일리안
[SS포토]'호구의 사랑' 유이, 건강미의 상징 꿀벅지는 어디 간겨?	스포츠서울
[포토] 씨스타 '스포티한 컨셉으로 건강미 과시'	스포츠조선
[스포츠경향 포토]‘2017 머슬마니아’ 건강미 열전	스포츠경향
미나, '건강미 돋보이는 시스루'	서울경제
[포토] 소나무 의진 '레깅스로 돋보이는 건강미'	한국경제
브룩 쉴즈 근황, 건강미 넘치는 동안 미모 [포토화보]	스포츠동아
UFC가 인정한 유승옥 "건강미 앞세운 옥타곤걸 기대하세요" [심층인터뷰]	엑스포츠뉴스
송지은. 섹시+건강미까지 “비법은 피네테스”	서울경제
클라라, 민소매 티 사이로 드러난 볼륨감…건강미 자랑 [똑똑SNS]	MK스포츠
[스포츠경향 포토]‘2017 머슬마니아’ 건강미 뒤태	스포츠경향
미나, '건강미 돋보이는 시스루'	서울경제
[포토] 소나무 의진 '레깅스로 돋보이는 건강미'	한국경제
브룩 쉴즈 근황, 건강미 넘치는 동안 미모 [포토화보]	스포츠동아
UFC가 인정한 유승옥 "건강미 앞세운 옥타곤걸 기대하세요" [심층인터뷰]	엑스포츠뉴스
송지은. 섹시+건강미까지 “비법은 피네테스”	서울경제
클라라, 민소매 티 사이로 드러난 볼륨감…건강미 자랑 [똑똑SNS]	MK스포츠
류 쿠마가이, 당당한 비키니 자태…‘넘치는 건강미’	베타뉴스
건강미 넘치는 제시	연합뉴스
<포토뉴스> 구하라, 건강미 넘치는 해변의 여신	헤럴드경제
<포토뉴스> 구하라, 건강미 넘치는 해변의 여신	헤럴드경제
레드벨벳 아이린, 건강미 넘치는 S라인 [MK포토]	MK스포츠
[사진]체리블렛 유주-지원, '건강미 뽐내며'	OSEN
[포토]머슬마니아 김근혜, 건강미의 대명사	한국경제TV
[포토] 건강미 넘치는 예지	매일경제
고준희 "건강미는 필수, PT와 필라테스 병행 중" [화보]	헤럴드POP
전효성, '몽환+육감+관능' 발리 화보…건강미 물씬 '서른한 번째 여름'	스포티비뉴스
시크릿 정하나, `건강미 넘쳐` [MBN포토]	MBN
솔비 근황, 섹시한 시스루룩 '감출 수 없는 볼륨' 건강미 발산	스포츠조선
[포토] EXID LE, '구릿빛 피부로 건강미 과시'	한국경제
'S.S.A' 건강미 넘치는 구리빛 미녀들[포토]	엑스포츠뉴스
[사진] 건강미 넘치는 라인	뉴스핌
씨스타 'touch my body' 뮤비, 건강미 넘치는 '탄력몸매'	스포츠조선
“제11회 MBN 건강美박람회” 온라인 개최	매경헬스
[사진]건강미 뽐내는 김희정	OSEN
[포토]포미닛 섹시 화보, '건강미+섹시함' 11자 복근 눈길	한국경제TV
강수진, 우아함 속 범접할 수 없는 건강미[화보]	스포츠조선
[포토엔HD] 소녀시대 유리 ‘건강미 넘치는 미소~’	뉴스엔
송진영, 건강미 넘치는 각선미 [MK포토]	MK스포츠
[포토] 한혜진 화보속 시원한 건강미	이데일리
[포토] 씨스타 '건강미 넘치는 마테바디'	한국경제
소녀주의보 지성, 광고계 러브콜 "60kg의 건강미가 적합"	엑스포츠뉴스
[경인포토]머슬퀸 정아름-지나, 건강미 넘치는 보디라인 '시선강탈'	경인일보
선미 체중 증가, 건강미 강조를 위한 소속사측의 조치	IT조선
있지 `당찬 건강미로 썸머퀸 정조준` [MK화보]	MK스포츠
정아름, 건강미 넘치는 화보 공개	이데일리
'나혼자산다' 소유, 수준급 수상스키 실력 공개 '건강미 발산'	스포츠조선
아름다움과 건강미 돋보이는 원목 인테리어	나무신문
‘씨스타→배우’ 김다솜, 여전히 건강미 넘치는 보디라인[포토엔]	뉴스엔
배우 이하늬 화보 공개… 건강미 넘치는 섹시함	서울신문
배우 이하늬 화보 공개… 건강미 넘치는 섹시함	서울신문
브아걸 제아, 물오른 미모와 건강미 넘치는 화보 공개 ?	한국경제TV
"건강미 뿜뿜"…티아라 큐리, 시선강탈 핑크빛 비키니	스포츠조선
[포토] 유승옥, 건강미!	스포츠서울
[오마이포토] AOA 유나, 도발적인 건강미	오마이뉴스
옥타곤걸 유승옥, `건강미 넘치는 팔뚝` [MK포토]	MK스포츠
[포토엔HD] 이하늬 ‘건강미 넘치는 보디라인’	뉴스엔
조민수 `건강미 넘치는 미소` [MBN포토]	MBN
김혜진, 건강미 넘치는 뒤태 [MK포토]	MK스포츠
[포토] 건강미 넘치는 미소	매일경제
김혜진, 건강미 넘치는 뒤태 [MK포토]	MK스포츠
[포토] 건강미 넘치는 미소	매일경제
유빈, 건강미 넘치는 구릿빛 피부	뉴스1
[ST포토] 인주연, '돋보이는 건강미'	스포츠투데이
주원, 전역 후 상남자 됐다…건강미 폭발 광고 비하인드컷	TV리포트
선미, 건강미 때문에 체중 증가…‘여전히 마른 몸’	MBN
‘오늘부터 사랑해’ 임세미, 건강미 넘치는 인증샷 눈길	한국경제TV
[E포토]건강미 넘치는 안다의 무대	SBS funE
신수지, '건강미 넘치네'	뉴시스
[포토] 카라 박규리, 건강미 넘치는 파워댄스!	스포츠조선
[경향포토]브레이브걸스, 머슬퀸은 건강미 보여주는 것	경향신문
[스포츠경향 포토]AOA 유나, 건강미의 정석	스포츠경향
레인보우 오승아 `춤 출때도 건강미 넘쳐~` [MBN포토]	MBN
문가비, 광고 촬영 중에도 빛나는 건강미 [스타포토]	디지털타임스
이가은, 폴댄스까지…감탄사 부르는 건강미[비하인드컷]	뉴스엔
이성경, '건강미 넘치는 각선미'	서울경제
조여정 '건강미 가득'[엑's HD포토]	엑스포츠뉴스
[오마이포토] 카라, 활력넘치는 건강미	오마이뉴스
[포토]오지호, 건강미 돋보이는 미소	헤럴드POP
'미우새' 한예슬 "건강미 있는 남자가 이상형"…김종국 모친 '반색'	스포티비뉴스
이슬비, 운동 셀카 공개…건강미 발산	한국경제TV
브레이브걸스, 쇼케이스 현장 깜짝 공개 "건강미 넘치는 머슬퀸으로 컴백"	텐아시아
[스포츠경향 포토]‘맥스큐 머슬마니아’ 건강미에 도전하세요	스포츠경향
[포토] `슈퍼볼` 비욘세, 보디수트로 건강미 뽐내	이데일리
'나 혼자 산다' 소유, 섹시한 건강미 뽐내며 수상스키… 멤버들 '환호'	경인일보
[포토]효린, '건강미의 상징' 돋보이는 구릿빛 피부	한국경제TV
선미 체중 증가, "건강미와 여성미 살리기 위해"	조세일보
고나은, 건강미 넘치는 일상공개…성난 등 근육 눈길	한국경제TV
씨스타, 건강미 `물씬`… 화끈한 해변 화보 공개	매일경제
[포토]박신혜, 건강미 넘치는 각선미	이데일리
[MD포토] 설현 '건강미 넘치는 구릿빛 미소'	마이데일리
‘역시 머슬 챔피언’ 유승옥, 건강미 가득·탄력 몸매 수영복샷 보니	세계일보
[bnt포토] CLC 손 '건강미 가득'	bnt뉴스
진세연, 화보 공개 '섹시+건강미 넘쳐'	이데일리
[포토]걸스데이 혜리, 쇄골 미인 '건강미 철철~'	이데일리
[포토] 씨스타 보라 '건강미 돋보이는 무대 의상'	한국경제
[포토] '플래쉬' 나래, 건강미 넘치는	스포츠서울
[포토] 이시영 '초미니 스커트에 건강미가~'	스포츠조선
치어리더 배수현 `건강미 넘치는 근육질 몸매` [MK포토]	MK스포츠
최정원, 건강미 넘치는 자태	스포츠한국
장경희 3살 연상 사업가와 결혼, 건강미 넘치는 S라인 웨딩화보	한국경제TV
김아중 화보서 팔색조 매력 과시 '섹시+건강미'	경인일보
건강미 자랑하고 상품 받자	매일경제
브아걸 제아, 한껏 물오른 건강미…탄탄 그 자체[화보]	스포츠동아
조여정, 여성스러움에 건강미까지 '이국적 미모'	한국일보
황보, 3년 전 비키니 사진 공개…건강미 넘치는 몸매[SNS★컷]	뉴스엔
에이핑크 남주, 허리가 한줌..섹시+건강미	스타뉴스
할리 베일리 매력 돋보이는 포토... 건강미 넘치는 보디라인	경상일보
강남프로복싱, 한소아 모델 선정 이유 "건강미 외모와 쾌활한 성격"	스포츠조선
박서휘 아나운서, 시구 화제 '건강미 넘치는 롱다리 미녀'	위키리크스한국
효린-보라 `짧은 핫팬츠에 건강미 넘쳐` [MBN포토]	MBN
[스포츠경향 포토]‘머슬마니아 화보 촬영’ 안인선의 건강미	스포츠경향
[스경포토] [머슬마니아] 임아로, 남다른 건강미	스포츠경향
[포토]이태임, 건강미 발산	이데일리
정유나, '운동으로 다져진 몸매로 건강미 과시' (ICN KOREA)	뉴스타운
전효성, 확 달라진 분위기…돋보였던 건강미 어디로?	마이데일리
‘건강미 넘치는 미나, 청순미가 팡팡~’[포토엔HD]	뉴스엔
수영, 싱그러운 매력! 건강미 넘치는 윈터 애슬레저룩	패션엔
트로트 가수 조정민, 건강미 ‘레디 큐’ [화보]	스포츠경향
‘경이로운 소문’ 김세정, 악귀 감지율 100% 인간 레이더...치명 걸크러시 폭...	매일경제
수영, 싱그러운 매력! 건강미 넘치는 윈터 애슬레저룩	패션엔
트로트 가수 조정민, 건강미 ‘레디 큐’ [화보]	스포츠경향
‘경이로운 소문’ 김세정, 악귀 감지율 100% 인간 레이더...치명 걸크러시 폭...	매일경제
'8kg 증량' 선미, 레드립+볼륨 몸매로 완성한 섹시함...건강미에 '엄지 척'	헤럴드POP
이효리, 건강미 넘치는 언더웨어 화보 공개 '걸크러쉬' [화보]	엑스포츠뉴스
[포토]피트니스모델 이지윤, 건강미 넘치는 각선미	한국경제TV
헬로비너스 나라·유영, 독보적인 건강미 [화보]	엑스포츠뉴스
김지원 `섹시한 건강미` [MBN포토]	MBN
[사진]치어리더 김연정, '건강미 뽐내며'	OSEN
유이, `맨친` 다이빙 훈련서 수영복 입고 건강미 뽐내	이데일리
제시, 오프숄더 입고 건강미 자랑	스타뉴스
‘이별이 떠났다’ 조보아, ‘상큼 단발머리’ 대학생으로 변신! ‘건강미 뿜...	MBC연예
힘이 넘치는 머슬퀸 이예진, 건강미로 맥스큐 커버모델이 됐죠[포토]	스포츠서울
<나 혼자 산다>진동 댄스부터 파워 워킹까지 독보적인 나래미(美)	한국경제
[포토] 머슬퀸 허고니, 건강미 넘치는 며느리	디지털타임스
[포토] 건강미 넘치는 `섹시백`, 최고는 누구	매일경제
이시영, 탁구로 건강미 뿜뿜.."다음주 탁구 시합"	스타뉴스
이채영, 과감한 쩍벌 자세로 '후끈'…'넘치는 건강미'	스포츠서울
‘미운 우리 새끼’ 한예슬, 이상형은 김종국?…“넘치는 건강미, 외모 1등”	MK스포츠
이시영, 휴일에도 등산 삼매경… 이유 있는 건강미 스타 [SNS★컷]	뉴스엔
[포토] 유승옥, 피트니스 여신 '건강미 발산'	이데일리
전혜빈, 볼륨감 드러낸 건강미 넘치는 화보 '완벽 S라인'	스포츠조선
트와이스, 태국 광고 촬영현장 공개...건강미 '듬뿍'	텐아시아
“건강미” 옥주현, 10년만에 아로나민씨플러스 모델로 귀환	서울경제
[포토엔]씨스타 효린 ‘건강미 넘치는 미소~’	뉴스엔
'건강미 뽐내는 모델들'	뉴스1
가인, 건강미 넘치는 각선미 ‘아찔’	매일경제
박결, `골프로 다져진 건강미` [MK포토]	MK스포츠
‘제주 새댁’ 윤진서, 하와이 사로잡은 건강미 [화보]	스포츠동아
차오루, 건강미 넘치는 '헬시 보디' 공개	스포츠서울
강한나 , 이름표 부착한모습 건강미가 , 캐미가	당진신문
[포토] 씨스타, 건강미 넘치는 무대	매일경제
조여정, 완벽 비율에 범접할 수 없는 건강미	헤럴드경제
건강미 넘치는 솔빈, 라붐 쇼케이스[SS포토]	스포츠서울
손태영, 자기 관리의 끝판왕…♥권상우가 반한 건강미 [★해시태그]	엑스포츠뉴스
추성훈·야노시호, 건강미 넘치는 카리스마 부부	동아일보
브레이브걸스, '건강미 넘치는 포즈'	뉴스1
[포토] 정아름 '태닝피부로 돋보이는 건강미'	한국경제
건강미 가득…성훈 여름 패션 화보	베타뉴스
[포토]션, 건강미 넘치는 등장	헤럴드POP
[포토]션, 건강미 넘치는 등장	헤럴드POP
코카콜라, 유인나 ‘태양의 신체건강 W' TV 광고 현장 공개	조세일보
걸스데이 유라, 복분자주 모델 발탁 '건강미 통했다'	뉴스1
[스포츠경향 포토]‘2017 머슬마니아’ 건강미 어떤가요	스포츠경향
[스포츠경향 포토]‘2017 머슬마니아’ 건강미 담긴 복근	스포츠경향
제시, 스윔웨어 입고 건강미 과시 ‘신이 내린 몸매’[화보]	뉴스엔
[스포츠경향 포토]제가 건강미 여왕	스포츠경향
[스포츠경향 포토]‘머슬마니아’ 건강미는 내가 최고	스포츠경향
[경인포토]원더걸스 유빈, 건강미 넘치는 구릿빛 피부 '시선 싹쓸이'	경인일보
윤계상, 화보서 독보적 매력 과시…건강미 '물씬'	머니투데이
[스포츠경향 포토]‘2017 머슬마니아’ 건강미 한껏 담았어	스포츠경향
제시, 스윔웨어 입고 건강미 과시 ‘신이 내린 몸매’[화보]	뉴스엔
[스포츠경향 포토]제가 건강미 여왕	스포츠경향
[스포츠경향 포토]‘머슬마니아’ 건강미는 내가 최고	스포츠경향
[경인포토]원더걸스 유빈, 건강미 넘치는 구릿빛 피부 '시선 싹쓸이'	경인일보
윤계상, 화보서 독보적 매력 과시…건강미 '물씬'	머니투데이
공현주, 건강미 뿜뿜 무결점 수영복 자태[SNS★컷]	뉴스엔
[포토] 네이처 '건강미 발산하며~'	스포츠조선
나나, 화보 공개 '건강미 발산'	이데일리
민도희, 건강미 물씬	헤럴드경제
공현주, 건강미 뿜뿜 무결점 수영복 자태[SNS★컷]	뉴스엔
[포토] 네이처 '건강미 발산하며~'	스포츠조선
나나, 화보 공개 '건강미 발산'	이데일리
민도희, 건강미 물씬	헤럴드경제
[포토] 최여진, '건강미 넘치는 매력'	한국경제
[bnt포토] 서리나 '눈길끄는 건강미'	bnt뉴스
씨스타 소유, '나혼자 산다'서 수상스키 실력+건강미 과시	이데일리
[포토] 우주소녀, 건강미 물씬~!	스포츠서울
아레나, 우아한 건강미 '문가비'와 함께한 S/S 블랙핑크 수영복 공개	머니투데이
에바 포피엘, 선명한 복근+건강미 넘치는 근황 "55kg 유지"	뉴스컬처
클라라, 달의 여신 같은 자태..건강미 넘치는 글래머러스 몸매	헤럴드POP
[사진]ANS 비안, '건강미 넘치는 출근길'	OSEN
유이, 숲속에서 우아한 화보 ‘건강미 넘치네’	스냅
[화보]소이현, 만삭화보…건강미 가득	매일경제
[슬라이드 화보] 문가비-한현민, 구릿빛 건강미 (오션월드)	아주경제
[화보] 전혜빈, 건강미 넘치는 바디라인	매일경제
씨스타는 벌써 여름? 워터파크 모델로 발탁돼 건강미 과시	스포츠조선
예정화, 건강미에서 뿜어져 나오는 아우라 (화보)	스포츠서울
[포토]효린, 건강미 넘치는 '구릿빛 피부'	헤럴드POP
루이 `건강미 넘치는 춤` [MBN포토]	MBN
보라 `건강미 넘치는 각선미` [MBN포토]	MBN
신아영, 건강미 돋보이는 드레스 자태(대종상영화제)	스포츠한국
나인뮤지스 경리, 건강미 뽐내는 수영복 화보 공개 “탄탄한 건강미”	서울경제
더 예뻐진 효린, 따라올 자 없는 건강미	매일경제
이시영, 건강미 넘치는 워킹! (인천공항 출국)	서울경제
티파니 복근 공개, 건강미 넘치는 탄탄한 몸매	매일경제
유승옥, 건강미 넘치는 화보 공개 '파워풀한 섹시미'	헤럴드경제
[포토] 시그니처 선 ‘건강미 넘치는 포즈’	스포츠동아
AOA 초아, 스포츠브랜드 화보공개 ‘통통 튀는 건강미’	스포츠동아
[포토S] 유현주, 태양에 탄 건강미 넘치는 몸매	스포티비뉴스
[포토] 에버글로우, 오늘도 건강미 넘치게	매일경제
[포토] 예지, 건강미 넘치는 출근길	매일경제
이미도 `건강미 넘치는 포즈` [MBN포토]	MBN
'미운 우리새끼'한예슬, 이상형 공개..."꽃미남 보다 건강미"(종합)	헤럴드POP
[포토]배그린, 탄탄 복근 '눈길'	이데일리
현아, 건강미 뽐내는 한 발 앞선 여름 화보	스포츠경향
[포토] 예지-리아, 건강미 넘치게!	매일경제
소녀주의보, 건강미 넘치는 매력 (쇼케이스)	서울경제
면연력에 좋은 '벌교 꼬막과 장흥 매생이'로 건강미식여행	투어코리아뉴스
[패션엔 포토] 마마무 화사, 크롭탑으로 건강미 넘치는 섬머룩	패션엔
[패션엔 포토] 마마무 화사, 크롭탑으로 건강미 넘치는 섬머룩	패션엔
신수지, `건강미 넌치는 각선미` [MK포토]	MK스포츠
[포토S] 이시온, 건강미 넘치는 몸매	스포티비뉴스
김예진, '환한 웃음으로 건강미 넘치는 몸매를 뽐내고 있다!' (몬스터짐코리아...	뉴스타운
[화보]김유정, ‘갑상선 기능 이상’ 떨치고 ‘건강미 물씬’	스포츠경향
AOA 설현 화보, 청순-섹시 넘나드는 매력 ‘돋보이는 건강미’	한국경제
강승현X구재이, 건강미+섹시 다잡은 시선강탈자 [화보]	스포츠동아
아인 `건강미 넘쳐` [MK포토]	MK스포츠
[주말 가볼만한 곳] 농어산촌 여행 재미?… '세련미' 보다 '건강미'	중부일보
한혜진,톱모델의 숨막히는 '뒷태' 건강미 물씬	스포츠서울
모모랜드 연우, '공황장애 극복' 건강미 넘치는 섹시 바디라인 (NC화보)	뉴스컬처
[OBS포토] 이하늬, 건강미 넘치는 매력	OBS
[오마이포토] 건강미하면 '씨스타'	오마이뉴스
건강미 넘치는 이하늬	연합뉴스
치어리더 `건강미 넘쳐` [MK포토]	MK스포츠
정다래, '건강미 넘치는 모습' (캘빈클라인)	서울경제
노년층 건강미 뽐낸다	내일신문
[포토엔]걸스데이 소진, 건강미 넘치는 무대	뉴스엔
[SS포토] 혜리, 건강미 탑재한 워킹 (하이드 지킬, 나)	스포츠서울
루나, 초밀착 운동복 입고 뽐낸 늘씬 몸매…'건강미 물씬'	마이데일리
[포토]머슬마니아 전혜빈, 건강미의 대명사	한국경제TV
조여정, 건강미 vs 청순미…극과 극 매력 오간다	TV리포트
[스포츠경향 포토]건강미의 여신으로 돌아온 AOA	스포츠경향
단발 변신 전소미, 건강미 넘치는 매력 '통통'	스타뉴스
명동 들썩이게 만든 이하늬 ‘국보급 건강미’ 자태	스포츠경향
‘나 혼자 산다’ 박나래, 독보적인 건강미로 매력 폭발	TV리포트
윤진서 "제주도 삶, 스스로 의미 찾는 치열함 생겼다"… 우아+건강미 넘치는 ...	경인일보
신수지, '건강미 넘치는 포즈로'	뉴시스
대선 앞둔 푸틴, 정교회 축제서 얼음물 목욕···‘건강미’ 과시	서울경제
건강미 넘치는 유리	노컷뉴스
대선 앞둔 푸틴, 정교회 축제서 얼음물 목욕···‘건강미’ 과시	서울경제
건강미 넘치는 유리	노컷뉴스
[포토]호주교포 이민지 '건강미 뽐내는 미모'	스포츠서울
[OBS포토] 아이오아이, 첫 완전체 화보 공개 '건강미 물씬'	OBS
'살 찌워 50 kg 달성' 선미, 건강미 넘쳐진 오늘자 사진	위키트리
[포토S] 이윤지 SPOFIT 심사위원, 건강미 넘치는 구릿빛 피부	스포티비뉴스
건강미 뽐내는 헬스장 패션	뉴스1
손연재, 건강미 넘치는 일상…시크美까지 장착 [화보]	스포츠동아
[건강미박람회] 동원F&B, 프리미엄 차 음료 브랜드 '동원 보성녹차' 박람회 참...	매경헬스
[포토]효린, 걸그룹 최고의 건강미 '두 말하면 잔소리'	한국경제TV
마마무 화사, 파격적인 데님룩…"독보적인 건강미"	머니투데이
[포토]이장숙, '건강미 넘치는 보디라인'	이데일리
[Oh!쎈 컷] "건강미vs청순미"..조여정, 극과 극 오가는 반전 매력	OSEN
[포토]'여성 보디빌더' 이현민·홍유리·홍주연 '건강미'	이데일리
오인혜, 건강미 넘치는 복근 공개	매일경제
[스포츠경향 포토]‘맥스큐 머슬마니아’ 선수들의 건강미 포즈	스포츠경향
레이양, 무보정 무굴욕 사진..'건강미의 대명사'	뉴스1
[포토] 소지섭, 건강미 물씬~	스포츠서울
[포토] 김희정, 스포티한 브라톱 래시가드로 건강미 뽐내	이데일리
로드FC 뉴 로드걸 세레나 “꾸미지 않은 건강미로 승부하겠다”	로드FC
레이양, 무보정 무굴욕 사진..'건강미의 대명사'	뉴스1
[포토] 소지섭, 건강미 물씬~	스포츠서울
[포토] 김희정, 스포티한 브라톱 래시가드로 건강미 뽐내	이데일리
로드FC 뉴 로드걸 세레나 “꾸미지 않은 건강미로 승부하겠다”	로드FC
[문화포토] 안신애 '건강미 넘치는 각선미'(살롱파스컵)	문화뉴스
강소라, 건강미 넘치는 각선미 [MK포토]	MK스포츠
최수영, 건강미 넘치는 패션 화보 공개	스포츠한국
김희정, 맥주 광고 모델 발탁…‘건강미 어필’	MBN
Reebok 2016 코치스 쓰로다운 대회, '건강미를 뽐내며'	뉴스1
[골든디스크] 트와이스 지효, `건강미 느껴져~`	MBN
조윤희, 섹시미+건강미 넘치는 화보 공개 '시선집중'	충청일보
AOA, 새 앨범 ‘굿럭’ 콘셉트 포토 추가 공개…‘건강미 물씬’	MBN
[포토] 이효리, 건강미 넘치는 제주 여자!	스포츠조선
'善' 우희준, '카바디 국가대표 선수의 건강미'	뉴스1
[포토] 치어리더 '건강미 뽐내요'	스포츠조선
'필라테스' 정려원, 늘씬한 몸매 '눈길'…'건강미 뿜뿜'	조이뉴스24
치어리더 이나경 '건강미 가득한 바디라인'[엑's HD포토]	엑스포츠뉴스
마동석 ‘건강미 넘치는 손인사’(신과 함께-인과 연)[포토엔HD]	뉴스엔
선미, 건강미 넘치는 매력 발산	경남데일리
박결 `건강미 넘치는 각선미` [MK포토]	MK스포츠
박결 `건강미 넘치는 각선미` [MK포토]	MK스포츠
슈퍼모델 니나 아그달, 피트니스 앱 통해 건강미 전파해	스포츠서울
안다르, 2020 F/W 마마무 새 화보 공개	메디컬투데이
"건강미 최고"..소녀시대 유리, 발랄한 매력	스타뉴스
‘건강미 넘치는 요요미, 청순미가 팡팡~’[포토엔HD]	뉴스엔
김연아, 건강미 넘치는 피겨퀸 [화보]	엑스포츠뉴스
[포토] 지성, 건강미 넘치는 아이돌	매일경제
[포토]역기 든 이연 '건강미 넘치는 뒷모습을 위해선'	이데일리
채정안, '건강미 넘치는 걸음걸이' (슈츠 종방연)	서울경제
‘정은우와 결별’ 박한별, 근황 사진 보니…건강미 폭발	MBN
최희, 넘치는 건강미 [MK포토]	MK스포츠
[포토]박민우, 건강미가 넘치는 에너자이너	이데일리
배우 수현, 건강미 넘치는 매력 화보 공개	부산일보
‘10월 결혼’ 곽지민 “이상형? 건강미 넘치는 스타일” 발언 재조명	서울신문
박신혜 관악산 등산, 건강미 넘치는 모습	MBN
'운동복도 섹시해'…강예빈, 레깅스 입고 건강미 발산	마이데일리
설현 청바지 모델로 건강미 발산	텐아시아
화사, 탄탄한 복근에 건강미 넘치는 화보…"지금 가장 행복하면서도 불안"	스포티비뉴스
f(x) 루나, 구릿빛 피부·비키니로 뽐낸 건강미 [★해시태그]	엑스포츠뉴스
김야니, 인스타 미모 보니...'건강미 만점'	뉴스컬처
선미, 몸무게 50kg 돌파 인증샷 공개.. “업그레이드된 건강미로 생기 뿜뿜”	뉴스투데이
무엇이든 잘 먹을 것 같은 건강미 넘치는 스타 1위 '정국' 2위 '화사', 그 밖...	디지틀조선일보
[스경포토] [머슬마니아] 김근혜, 럭비의 건강미	스포츠경향
[스경포토] [머슬마니아] 임아로, 빈틈 없는 건강미	스포츠경향
"어떤 날은 힙하고 싶어"…가희, 발리에서 뽐낸 건강미+수영복 자태	마이데일리
씨스타 효린, 화보 통해 건강미 넘치는 서퍼걸 변신 ‘시선집중’	한국경제
이하늬, 건강미 넘치는 완벽 바디라인[화보]	헤럴드POP
피트니스웨어로 건강미 뽐내며	연합뉴스
나인뮤지스 경리, 건강미 드러낸 레깅스룩[포토엔]	뉴스엔
고흥'수호천사건강미'6년 연속 전남 10대 브랜드쌀 선정	전남일보
피트니스웨어로 건강미 뽐내며	연합뉴스
나인뮤지스 경리, 건강미 드러낸 레깅스룩[포토엔]	뉴스엔
고흥'수호천사건강미'6년 연속 전남 10대 브랜드쌀 선정	전남일보
[포토]제시, 래시가드 화보 '건강미'	이데일리
[스포츠경향 포토]건강미 담긴 뒤태 열전	스포츠경향
레이디스코드 애슐리 오늘(17일) 첫 솔로 발매…'청량+건강미 발산'	엑스포츠뉴스
[화보]고나은, 밀착의상으로 관능미+건강미 과시	뉴스1
전효성 거울 셀카, 건강미 넘치는 각선미 '감탄'	머니투데이
'태양의 신체건강 W' 건강미녀 유인나의 TV 광고 비하인드 컷 공개	경인일보
쇼호스트 장경희, 건강미 넘치는 웨딩 화보	데일리안
쇼호스트 장경희, 건강미 넘치는 웨딩 화보	데일리안
[스포츠경향 포토]‘머슬마니아’ 건강미의 향연	스포츠경향
[포토]'여자친구' 예린, 건강미 넘치네!	헤럴드POP
[MD포토] 이태란 '건강미 넘치는 각선미'	마이데일리
제시 '건강미 넘치는 보디라인'[포토]	엑스포츠뉴스
배수현, `가장 눈에 띄는 건강미` [MK포토]	MK스포츠
이하늬, 미스코리아의 건강미 넘치는 레깅스 핏	스포츠서울
건강미 넘치는 씨스타	뉴시스
'건강미는 내가 최고'	연합뉴스
‘아이언 레이디’ 윤소희, 운동하는 자태도 남달라…‘건강미 물씬’	MBN
'건강미는 내가 최고'	연합뉴스
‘아이언 레이디’ 윤소희, 운동하는 자태도 남달라…‘건강미 물씬’	MBN
[EBS 머니톡] '아이 둘' 원조 외국인 스타 에바 포피엘…건강미 한도 초과 라...	오가닉라이프신문
'식객남녀3' 정가은, '반전 드레스'로 섹시 건강미 발산	스포츠조선
손미나, 여행 중 뽐낸 비키니 자태 '건강미 넘쳐'	스포츠서울
[스포츠경향 포토]‘2017 머슬마니아’ 이수지, 백조의 건강미	스포츠경향
[스포츠경향 포토]‘2017 머슬마니아’ 최고의 건강미를 가리자	스포츠경향
[스포츠경향 포토]‘머슬마니아’ 최고의 건강미를 가리자	스포츠경향
달샤벳 가은 `건강미 넘치는 각선미` [mk포토]	MK스포츠
제이니, `건강미 넘치는 11자 복근` [MBN포토]	MBN
[스포츠경향 포토]‘2017 머슬마니아’ 의상과 건강미의 조화	스포츠경향
[스포츠경향 포토]‘머슬마니아’ 최고의 건강미를 가리자	스포츠경향
달샤벳 가은 `건강미 넘치는 각선미` [mk포토]	MK스포츠
제이니, `건강미 넘치는 11자 복근` [MBN포토]	MBN
AOA 지민, 식사 후 건강미 넘치는 웃음	스타뉴스
[경인포토]김예림, 건강미 넘치는 섹시 각선미	경인일보
"건강미란 이런 것"…헬로비너스 라임, 눈부신 바디라인 [화보]	스포츠조선
최희, 밀착 요가복입고 건강미 과시 ‘탄탄하네’	매일경제
"이 느낌 좋아" 거북이 출신 금비, 건강미 넘치는 근황[★SHOT!]	OSEN
[포토] 치어리더 '건강미 담아 뿜뿜'	스포츠조선
[포토] 이연, 건강미 넘쳐	이데일리
이하늬 코사무이, 건강미 섹시미 한번에…극강 비주얼	헤럴드경제
[사진]임보라, '건강미 뽐내며'	OSEN
설현, 광고컷 공개.. 도심 속 러닝 '건강미 발산'	이데일리
정은지, 섹시&건강미 발산··푸마 '칼리(CALI) 슈즈' 화보	G밸리뉴스
머슬마니아 최미진, 수영복으로 건강미 과시	스포츠경향
솔비 근황, 속옷 드러나는 시스루 의상으로 '건강미 발산'…"더 예뻐졌네"	스포츠조선
이하늬, 롱패딩도 가릴수 없는 독보적 건강미[포토엔]	뉴스엔
박신영 아나운서, `돋보이는 건강미` [MK포토]	MK스포츠
가수 방미, 나이 잊은 동안 외모와 건강미 '관심 집중'	뉴스렙
[포토] 티아라 은정 '건강미 넘치게'	스포츠조선
[사진]건강미 뽐내는 러너	OSEN
클라라 해명 "레깅스 시구는 하체 건강미 보여주기 위한 것"	IT조선
‘토크몬’ 소유, 셀프 폭로 “건강미 비키니 화보, 알고보면 포샵”	MK스포츠
공유, 건강미 넘치는 섹시남 변신…여심 퐁당[화보]	스포츠동아
섹시 아이콘 김희정, 건강미 넘치는 래쉬가드 수영복 화보 공개	한국경제TV
[포토] 탄탄한 건강미 뽐내는 여성 보디빌딩 선수들	서울신문
"바다 접수한다"…씨스타, 건강미 넘치는 해변 화보	엑스포츠뉴스
'건강미의 대명사' 이하늬, 화보서 탄탄한 복근+애플힙 공개	한국경제
이성경, 아식스 새 뮤즈로 건강미 뽐내	스포츠조선
김희정, 건강미 넘치는 '워너비 몸매'…다이어트도 힙하게	TV리포트
배우 이태임, 3kg 증량 효과?… 되찾은 '건강미 발산'	아시아경제
래퍼 예지, `건강미 넘치는 S라인` [MBN포토]	MBN
[SS포토] 걸스데이 유라, 건강미 넘치는 꿀벅지	스포츠서울
볼빨간사춘기 우지윤 '탄탄한 건강미로 돌아왔어요' [포토]	부산일보
'역도요정 김복주' 이성경 "건강미 강조에 초점 두고 몸 만들어"	경인일보
[엑's HD포토] 애슐리 '섹시에 건강미 더한 매력'	엑스포츠뉴스
[포토] 치어리더, 건강미 넘치는 몸매	스포츠조선
조여정, 건강미에서 청순미까지 `워너비 여신`	매일경제
[서병기 연예톡톡] 씨스타, 건강미 자체의 건강함	헤럴드경제
걸그룹 솔티 건강미 부각…러브콜 쇄도	스포츠동아
고원희, 건강미 넘치는 각선미 [MK포토]	MK스포츠
[화보] 이태임, 래시가드로도 감출 수 없는 건강미	부산일보
[포토]건강미 넘치는 씨스타 효린	이데일리
[bnt포토] 유승옥 '건강미 물씬!'	bnt뉴스
루나 `건강미 넘치는 구릿빛 피부` [MBN포토]	MBN
[포토] 김한나 '건강미 넘치는 볼륨감'	스포츠조선
김희정, 구릿빛 피부에 돋보이는 건강미…감탄 자아내는 몸매	마이데일리
김재경, 탄탄한 건강미 돋보이는 화보 공개	비즈엔터
[오마이포토] 씨스타, '구릿빛 건강미'	오마이뉴스
[스포츠경향 포토]‘피트니스스타’ 청순 건강미	스포츠경향
'골든크로스' 이시영, 런닝 머신 포착 '건강미 물씬'	OBS
[포토] 소녀시대 유리 '건강미 넘치는 구릿빛 각선미'	한국경제
‘쿨~한 건강미’ 금새록, 대세 광고 꿰찼다	국방일보
이엘, ‘도깨비’ 삼신할매 벗고 건강미 발산..시크한 아우라 ‘감탄’	한국경제
'제주도 신부' 윤진서, 건강미 넘치는 웨딩 화보 공개	아시아경제
[포토]씨스타 보라, 수수해도 건강미는 그대로	이데일리
[영상] ‘짐승돌’ 모모랜드 연우의 ‘건강미’	민중의소리
[포토] 이하늬, 건강미 넘치는 미모!	스포츠조선
[경인포토]씨스타 쇼케이스, 'touch my body'로 완전체 컴백… '건강미 과시'	경인일보
[스포츠경향 포토]AOA, 건강미 넘치는 여신으로 복귀	스포츠경향
‘소녀의 건강미?’ I.O.I(아이오아이) 첫 완전체 화보 공개	헤럴드경제
'건강이상설' 씨엘, 공식석상서 건강미 뽐내	머니투데이
[포토] 씨스타 '건강미 넘치는 각선미'	한국경제
러블리즈 이미주, 넘치는 건강미 [MK포토]	MK스포츠
나르샤, '즐거운 감량생활'로 다이어트 성공…건강미 발산 [화보]	엑스포츠뉴스
[사진]양정원, '매력적인 건강미 뽐내며'	OSEN
이상화, 헬스장 직찍 사진 포착! '건강미 넘치는 섹시미'	중도일보
[화보] 이하늬, 수영복 화보서 빛난 건강미..미모폭발	OSEN
[경인포토]브레이브걸스 유진, 건강미 넘치는 보디라인	경인일보
도희, 필라테스로 가꾼 건강미 넘치는 보디라인 [화보]	엑스포츠뉴스
[포토]브레이브걸스, '머슬퀸'이란 단어에 채울 수 없는 건강미	조이뉴스24
KCC 치어리더 '건강미 넘치는 섹시미'[포토]	엑스포츠뉴스
솔비, 일상 속 넘치는 건강미 발산	뉴스1
진세연, 섹시+건강미 넘치는 매력발산	뉴데일리
'동안 여신' 솔비 근황, 수영복 사진 건강미 여전하네	한국경제TV
효린 `건강미 넘치는 미소` [가요대축제]	MBN
고성희, 짧고 달라붙는 의상에도 굴욕은 커녕 건강미 물씬	이데일리
[스포츠경향 포토]‘맥스큐 머슬마니아’ 김인선, 이국적 미모와 건강미	스포츠경향
[스포츠경향 포토]‘맥스큐 머슬마니아’ 윤혜주, 당당한 건강미	스포츠경향
[스포츠경향 포토]‘맥스큐 머슬마니아’ 최은솔, 건강미의 향연	스포츠경향
[포토] 이연화, 건강미 물씬~!	스포츠서울
[스포츠경향 포토]‘맥스큐 머슬마니아’ 김다혜, 건강미 한껏 담았어	스포츠경향
포미닛 권소현은 복근가왕? SNS로 건강미 발산	국민일보
이혜영, 수국꽃 옆에서 뽐낸 모델 몸매..구릿빛 건강미[★SHOT!]	OSEN
[화보] 머슬마니아 안인선, 수영복 입고 시원한 건강미 과시	스포츠경향
[포토] 건강미 넘치는 박혜신	매일경제
선미, 증량으로 만든 건강미	스포츠한국
하연주, 건강미 넘치는 비키니 몸매 인증..한 폭의 그림같아	헤럴드POP
[경향포토]로봇 소리 이하늬, 건강미 넘치는 발걸음	경향신문
선미, 증량으로 만든 건강미	스포츠한국
하연주, 건강미 넘치는 비키니 몸매 인증..한 폭의 그림같아	헤럴드POP
[경향포토]로봇 소리 이하늬, 건강미 넘치는 발걸음	경향신문
AOA 설현, 청순-건강미 넘치는 뷰티화보 공개	마이데일리
연우 `건강미 넘치는 워킹` [MK포토]	MK스포츠
[포토]유빈, 탄탄한 건강미	헤럴드POP
조여정 건강미. 화이트 점프 슈트 아래로 드러난… '감탄'	경기일보
황치열, 즐거운 저녁식사... 돋보이는 건강미	TV리포트
미코 출신 정아름, 건강미 흘러넘치는 비키니 화보	스포츠동아
'마리텔' 우주소녀 성소, 서핑수트 입고 S라인 공개…'건강미 물씬'	문화뉴스
미샤 테이트, UFC 넘어 ‘섹시한 건강미’ 끝판왕	뉴스웨이
이일화, 하와이서 탄탄한 복근+20대를 능가하는 건강미…'강렬한 매력'	국제신문
정우성, 남성+건강미 넘치는 훈훈한 ‘대표님’	한국경제TV
[포토]김연아, 건강미 돋보이는 스타일 제안	이데일리
이수혁·수현, 서머 스포츠 데이트?..건강미 `물씬`	이데일리
[포토]배우 서리나, '건강미 가득'	이데일리
[스포츠경향 포토]건강미 넘치는 씨스타 효린	스포츠경향
[건강미박람회] 김정문알로에, 시즌3 '큐어 알로에 슬라이스 젤리 마스크' 박...	매경헬스
박보람, 레드 탱크톱+핫팬츠 입고…건강미 넘치는 모습	머니투데이
이하늬, 르까프 2014 봄 화보에서 건강미 자랑해	스포츠조선
'안녕하세요' 오정연, 11kg 감량 성공 건강미 넘치는 몸매로 컴백 [Oh!쎈 컷...	OSEN
가인, 건강미 넘치는 탄탄한 각선미 공개	부산일보
김재경, 스포츠웨어 광고 모델 발탁...NS윤지와 함께 건강미 과시	서울경제
트와이스 지효 '건강미 과시'[엑's HD포토]	엑스포츠뉴스
[MD화보] '마르기만 한 건 아냐'…김연정, 건강미 넘치는 각선미	마이데일리
[포토] AOA '건강미와 섹시미 다 잡았다'	스포츠조선
[포토] 씨스타 보라, 화보 통해 에너치 넘치는 건강미 발산	MBN
카라 새 멤버, 첫번째 후보 '소진' 공개. 발랄+건강미 매력	스포츠조선
유인영, 건강미 과시 '쭉뻗은 인형몸매'	스포츠월드
강세정, 요가 화보로 무결점 건강미 과시...“새로운 것에 도전하는 게 좋아요...	MBC연예
강세정, 요가 화보로 무결점 건강미 과시...“새로운 것에 도전하는 게 좋아요...	MBC연예
[TEN PHOTO]소녀주의보 샛별 '건강미 넘치는 각선미'	텐아시아
[화보] 효린, 역시 건강미 최고..핫한 매력	OSEN
손연재, 오션월드 광고 모델 발탁…건강미 발산	엑스포츠뉴스
마마무 화사, 워터파크 모델 됐다…수영복 입고 건강미 발산	조이뉴스24
이효리, ‘하이컷’서 건강미 물씬 보디라인 공개	스포츠한국
[포토]머슬마니아 이휘진 수영복, 건강미 끝판왕	한국경제TV
[포토] 시크릿 '빨간 핫팬츠 입고 건강미 자랑'	스포츠조선
[엑's HD] DB 치어리더 '건강미 발산'	엑스포츠뉴스
가희-유승옥, 땀범벅 실제 운동 모습 포착 ‘건강미 물씬’	스포츠조선
[스포츠경향 포토]‘머슬마니아 화보 촬영’ 건강미 뽐내는 김시아	스포츠경향
[포토] 레인보우 지숙 '건강미 돋보이는 각선미'	한국경제
이하늬 '이것이 진정한 건강미'(화보)	문화뉴스
족구왕 황승언, 복근 공개…잘록한 허리에 건강미까지	MBN
브레이브걸스, 건강미 넘치는 ‘변했어’ 머슬퀸 콘셉트...꾸준한 ‘상승세’	한국경제
[포토엔HD] 이하늬 ‘가죽초미니에 드러난 건강미 넘치는 각선미~’	뉴스엔
'머슬한양', 휘트니스 문화 시작의 불을 붙히다	한양대학교 사자후
[스경포토] [머슬마니아] 김근혜, 시선 사로잡는 건강미	스포츠경향
‘대세녀’ 양정원, 건강미와 섹시미 동시에 ‘남성들 로망 충족’	동아일보
박기량 `건강미 넘치는 댄스` [MK포토]	MK스포츠
박기량 `건강미 넘치는 댄스` [MK포토]	MK스포츠
'나혼자산다' 박나래, 진동 댄스→파워 워킹, 다이어터 모드 전격 돌입	스포츠조선
이상화, 빙속 여제의 변함없는 건강미 "세계 제패 이유있다"	경기도민일보
정은지, 건강미 넘치는 운동 인증샷..."하고 나면 뿌듯" [★해시태그]	엑스포츠뉴스
고성희, 건강미 뽐낸 화보 "평소 좋아하던 이보영 '마더'로 만나"	enews24
지호 (오마이걸) ‘어깨 드러낸 건강미’[포토엔HD]	뉴스엔
[OBS포토] 전효성, 탄탄한 복근 과시 '건강미 물씬'	OBS
[스포츠경향 포토]‘머슬마니아’ 건강미 넘치는 뒤태	스포츠경향
"어머님이 누구니"...배우 이하늬, 섹시한 건강미	스포츠서울
[건강미박람회] "건강·뷰티 대축제 시작"	매경헬스
가희, 11자 복근과 각선미…화보로 건강미 발산	서울신문
조여정, 운동으로 다져진 건강미 넘치는 각선미 [화보]	엑스포츠뉴스
배우 조윤희, 구릿빛 피부의 건강미 넘치는 여름 화보 공개!	서울경제
손담비 '건강미 넘치는 스타일' [포토]	엑스포츠뉴스
이효리, 건강미 넘치는 늘씬한 뒤태 공개… '男心 저격'	이뉴스투데이
'섹시 퀸' 클라라, 中 화보 속 건강미 넘치는 매력	스포츠서울
유이 수영장 사진 공개 ‘돋보이는 건강미’	데일리안
'우리 건강미 넘치죠?'	연합뉴스
[포토] 치어리더 '건강미 가득 뿜뿜'	스포츠조선
이하늬, 누구나 부러워할 건강미	서울경제
'우리 건강미 넘치죠?'	연합뉴스
[포토] 치어리더 '건강미 가득 뿜뿜'	스포츠조선
이하늬, 누구나 부러워할 건강미	서울경제
배그린, 건강미 넘치는 화보 공개 "박신혜 조언으로 필라테스 시작"	스타데일리뉴스
치어리더 이수진, 건강미 넘치는 구리빛 피부 [MK포토]	MK스포츠
[포토] 엄정화, '건강미 돋보이는 얼굴'	스포츠조선
[경인포토]건강미 넘치는 모습으로 등장하는 조여정 "바쁘다 바뻐"	경인일보
독보적 분위기 여신, 발레리나 강수진..."범접할 수 없는 건강미"	한국경제TV
헬로비너스 나라, 화보 촬영장서 탄탄 건강미 과시	스포츠동아
27kg 감량 다나, 어떻게 지내고 있나 들여다보니...건강미 넘치는 모습 '술렁...	경상일보
[TD영상] WBFF 아시아 론칭, '건강미를 보여드릴게요'	티브이데일리
지나 화보 공개, 건강미 넘치는 몸매로 섹시한 매력 발산	헤럴드경제
[포토] 손태영, 건강미 넘치는 미모!	스포츠조선
걸그룹 달샤벳, '맨즈헬스' 화보 공개…숨겨진 건강미 발산	스포츠서울
'마리텔' 성소, 서핑 슈트 완벽 소화 '건강미 넘쳐'	이데일리
[MD포토] 건강미 넘치는 트와이스 지효	마이데일리
AOA 지민, 사랑스러운 미소..건강미 더해진 모습	헤럴드POP
에이스, `건강미 넘치는 힙라인` [MBN포토]	MBN
‘마더’ 고성희, 건강미 넘치는 화보…“취미는 필라테스-여행-꽃꽂이”	국제신문
[포토] 강시원 '건강미 넘치는 복근 노출'	스포츠조선
[포토] 에이핑크 은지 '건강미 가득 발사'	스포츠조선
건강미 봐주세요	뉴스1
솔비 근황, 과감한 시스루에 속옷 노출…탄탄몸매 건강미 과시	스포츠조선
조윤희 화보, 청순외모와 달리 탄탄몸매로 ‘섹시 건강미’ 과시	한국경제
[화보] “갈수록 예뻐져”..김희정, 치명적 섹시+건강미	OSEN
[포토] 씨스타 '포즈도 건강미 돋보이게'	한국경제
나혼자산다 소유, 수준급 수상스키 실력 과시...건강미 ‘물씬’	메디컬투데이
청순미보다 건강미, ‘머슬녀’ 뜬다	스포츠조선
맹승지 '건강미 넘치는 바디라인'[포토]	엑스포츠뉴스
[포토]현아-제시, '건강미 발산'	이데일리
[포토] 이기우, 건강미...물씬~!	스포츠서울
[포토엔]티아라 효민 ‘건강미 넘치는 탄력각선미’	뉴스엔
[포토] '밀레 진실캠프' 줄넘기로 건강미 뽐내는 참가자들	스포츠조선
닭치고 서핑 가희, 서핑 즐기고 있는 사진 보니 건강미 넘치는 볼륨 몸매로 ‘...	MBN
[포토]션, 건강미 넘치는 구릿빛 피부	헤럴드POP
씨스타 효린, `넘쳐 흐르는 건강미` [MBN포토]	MBN
[포토]'여자친구' 은하, 건강미 넘치네!	헤럴드POP
[포토엔]씨스타 보라 ‘건강미 넘치는 미소~’	뉴스엔
현아 티저, 뒷모습만 봐도 건강미 넘쳐	매일경제
이하늬, `건강미 넘치는 S라인` [MBN포토]	MBN
이하늬, `건강미 넘치는 S라인` [MBN포토]	MBN
[포토] 다이아 예빈 '건강미 충만한 멜빵 패션'	스포츠조선
[포토] 다이아 '건강미 넘치는 마술소녀 컨셉'	스포츠조선
[E포토]여자친구, 건강미 넘치는 소녀들	SBS funE
"건강미 뽐내요"	연합뉴스
[POP이슈]'8kg 증량' 선미, 50kg 달성 인증→마른 몸매 탈피..건강미 향한 응...	헤럴드POP
김태린, 건강미 넘치는 라인	스포츠한국
'아이언 레이디' 윤소희, 촬영 중 건강미 발산…"땀 흘려도 섹시해"	머니투데이
서정희 딸 서동주, '집콕'도 섹시하게…건강미 가득 근황	미디어펜
이태임, 건강미 넘치는 아름다움! (품위있는그녀 제작발표회)	서울경제
김태린, 건강미 넘치는 라인	스포츠한국
'아이언 레이디' 윤소희, 촬영 중 건강미 발산…"땀 흘려도 섹시해"	머니투데이
서정희 딸 서동주, '집콕'도 섹시하게…건강미 가득 근황	미디어펜
이태임, 건강미 넘치는 아름다움! (품위있는그녀 제작발표회)	서울경제
선미 체중 증가, 솔로 활동 앞두고 5kg 늘려… "건강미 보여줄 것"	경인일보
7kg 감량 김새롬, 남성지 화보서 건강미 발산	이데일리
조여정, 광고 촬영서 건강미와 청순미 오가는 반전 매력 발산	국제신문
에일리 10kg 감량, 각선미 변천사 비교 '건강미→섹시미'	엑스포츠뉴스
‘솔로 데뷔’ 애슐리 “건강미 더해진 섹시 보여줄 것”	MBN
[포토] 송지은, 건강미 넘치는 미모!	스포츠조선
'도끼 사촌누나' 니콜 셰르징거, 일상 모습 '건강미 넘쳐'	엑스포츠뉴스
[포토] 이하늬, '건강미 넘치는 모습으로 등장~'	스포츠조선
건강미 뽐내는 모유 수유아	뉴시스
[포토] 치어리더 '건강미 가득한 복근 과시'	스포츠조선
건강미 과시하는 인간 북극곰	연합뉴스
‘야구여신’ 최희, 요가몸매 ‘아찔 볼륨’ 건강미 과시	스포츠조선
권유리, 건강미 넘치는 각선미[포토엔HD]	뉴스엔
[포토]머슬마니아 김태린, 건강미의 대명사	한국경제TV
[SS포토] 혜리, 건강미 물씬 풍기는 워킹 (하이드 지킬, 나)	스포츠서울
문가비, 건강미 넘치는 구리빛 뒤태 [MK포토]	MK스포츠
[스포츠경향 포토]‘피트니스스타’ 건강미 그 자체	스포츠경향
씨엘, 건강미 넘치는 화보 공개	스포츠경향
건강미 넘치는 보라	연합뉴스
[포토]미스 틴 USA, `건강미 넘치네`	이데일리
클라라-동준, 인천AG 성화봉송 "건강미+체육돌 이미지"	엑스포츠뉴스
[e포토] 오하영, 넘치는 건강미	enews24
문가비 '건강미 뿜뿜'	뉴시스
김준희, 건강미 넘치는 일상…살짝 드러난 복근에도 굴욕無	헤럴드POP
"핑크빛 S라인"…박신영 아나운서, 독보적 건강미 [화보]	스포츠조선
서현, 숨길 수 없는 건강미…여인의 향기도 물씬	부산일보
김준희, 건강미 넘치는 일상…살짝 드러난 복근에도 굴욕無	헤럴드POP
"핑크빛 S라인"…박신영 아나운서, 독보적 건강미 [화보]	스포츠조선
서현, 숨길 수 없는 건강미…여인의 향기도 물씬	부산일보
LE 계약해지 전 근황은? 해외서 비키니 입고 건강미 듬뿍	증권경제신문
보라-효연 `우열을 가리기 힘든 건강미` [MBN포토]	MBN
'미운우리새끼' 한예슬은 이상형은 건강미…김종국 母 함박웃음	엑스포츠뉴스
[포토] 김예림 '건강미 돋보이는 각선미'	한국경제
김미연, 비키니 근황 사진 공개 '건강미 넘치네'	엑스포츠뉴스
'미운 우리새끼' 한예슬, 독보적 미모 뽐내.."건강미 넘치는 남자 좋아"	헤럴드POP
장희령, 건강미 넘치는 각선미 [MK포토]	MK스포츠
[포토] 모델 칼리 크로스, 건강미 넘치는 드레스 자태	이데일리
이승현, `구리빛 피부, 건강미 철철~` [MK포토]	MK스포츠
[MD화보] '아이돌이 60kg면 어때요'…소녀주의보 지성, 건강미 넘치는 시구	마이데일리
전효성, `건강미 넘치는 각선미` [MBN포토]	MBN
'그날들' 윤지성, 첫 뮤지컬·첫 노출? "건강미 위해 PT 받는다"	한국경제
씨스타 워터파크 광고 모델, 건강미 넘치는 걸그룹의 위엄	서울경제
응팔 포상휴가, '덕선' 혜리...건강미 볼륨감 넘치는 반전 화보 눈길	전자신문
제10회 MBN 건강美박람회 개최 - 참가기업 모집 및 건강미 브랜드대상 공모	MBN
루나, 작정하고 드러낸 건강미 [MK포토]	MK스포츠
KGC인삼공사, 건강미 넘치는 ‘최수영’ 모델로 선정	중도일보
[사진]2014 미스 섹시백, 건강미 넘치는 댄스	OSEN
여름철 ‘확찐자’ 위한 뉴노멀 다이어트 경품 이벤트 ‘눈에 띄네’	로이슈
류효영, 운동으로 다져진 명품몸매···건강미+우아함 넘쳐	서울경제
[포토]개그우먼 이장숙, '비키니로 뽐낸 건강미'	이데일리
유승옥 건강미 넘치는 피트니스 화보 “엉덩이는 내 정체성”	스포츠경향
[포토] 씨스타 효린 '시선 집중 시키는 건강미'	한국경제
서효림, 탄탄 보디 라인 화보 공개...'건강미 물씬'	헤럴드경제
[포토] 구구단 세미나 세정, '건강미 넘치는 세동이~'	뉴스프리존
이태임, 감탄사 자아내는 탄탄 몸맵시…밀착 래시가드로 건강미 과시	일간리더스경제
'아는형님' 선미, '건강미' 칭찬에..."죽겠다 싶어 41kg→50kg 찌웠다"	뉴스인사이드
유승옥 '건강미 넘치는 바디라인'[포토]	엑스포츠뉴스
[리우2016] 건강미 넘치는 비치발리볼 선수	뉴시스
에일리 `건강미 돋보이는 워킹` [가요대축제]	MBN
장우혁 헬스 인증샷, 탄탄한 근육 드러내며 건강미 과시	매일경제
클라라, 청순 미모-건강미 넘치는 보디라인 '시선집중'… 진정한 완벽녀	경인일보
건강미 넘치는 美女들 ‘섹시백’ 경쟁	코리아헤럴드
청하 '건강미 뽐내며'[엑's HD포토]	엑스포츠뉴스
건강미박람회 대박 이벤트	매경헬스
Reebok 2016 코치스 쓰로다운 대회, '건강미를 뽐내는 참가자'	뉴스1
[스포츠경향 포토]‘머슬마니아’ 이수진, 건강미 알리려 출전했어요	스포츠경향
11번가, 올봄 패션 제안 “건강미+여성미”	ZDNet Korea
AOA 찬미, 설 연휴 '머슬퀸 프로젝트'로 건강미 발산	이데일리
[포토] 노출 없이도 건강미 뽐낼 수 있는 수영복	이데일리
브아걸 제아, 건강미 넘치는 화보 ‘물오른 미모’	뉴스엔
[MD포토] 김규리, '건강미 넘치는 미소'	마이데일리
[E포토]디홀릭, 건강미 넘치는 그녀들의 무대	SBS funE
[SS포토]SK 치어리더, 건강미 넘치는 몸매로	스포츠서울
[오늘의 포토] 가수 미나, 건강미 넘치는 화보 공개	서울신문
최여진-유승옥, 건강미 넘치는 화보 ’숨 막히는 S라인‘	매일경제
`머슬퀸` 이연화, 건강미 넘치는 각선미 [MK포토]	MK스포츠
이동욱, 2013 S/S 화보에서 건강미 발산	한국경제TV
[T포토] 황정음 '건강미 넘치는 구릿빛 피부'	TV리포트
[T포토] 이시영 '건강미 넘치는 등장'	TV리포트
한채아, 래시가드 화보 비하인드 컷…건강미 '물씬'	머니투데이
연우 `군살제로 건강미 과시` [MK화보]	MK스포츠
강예빈 'UFC 출정식' 참석…건강미 과시	아시아경제
[포토] 안다 '건강미 넘치는 각선미'	한국경제
수현·이수혁, 미모·건강미 다 가진 해변의 연인[화보]	헤럴드POP
[bnt포토] AOA 설현 '건강미 넘치는 보디라인'	bnt뉴스
'눈에는 눈 이에는 이' 건강미 한소아, 복싱걸로 변신	데일리안
[포토] 씨스타 보라, 굴욕없는 S라인 몸매로 ‘건강미 과시’	MBN
소녀주의보, 육십돌 타이틀에도 뷰티브랜드 모델 발탁..건강미 효과	MK스포츠
[포토] 소지섭, 건강미 과시하는...패션 센스!	스포츠서울
정미애 ‘무대위 건강미가 넘치는 매력’ [포토엔HD]	뉴스엔
포항국제불빛축제 '건강미는 보너스'	뉴스1
"독보적 건강미"…조여정, 밀착 레깅스로 드러난 완벽 비율 [화보]	마이데일리
베리굿 서율, 시선 사로잡는 건강미 "드림팀 출연 위해 운동 중"	스포츠서울
베리굿 조현, 하의실종 패션으로 뽐낸 날씬 몸매…'건강미 넘쳐'	마이데일리
[포토] 정인영, `스포츠 여신` 다운 건강미	이데일리
조여정, 건강미 vs 청순미 '극과 극' 오가는 반전 매력 발산, 매회 리즈 갱신...	뉴스타운
유승옥, 청순한 건강미 뽐내며 근황 알려	스포츠경향
[포토]건강미 넘치는 유승옥	헤럴드POP
‘나혼자산다’ 소유, 건강미 넘치는 뒤태…육중완 ‘화들짝’	헤럴드POP
[포토]배우 서리나, '섹시한 건강미'	이데일리
[똑똑SNS] ‘아는 형님’ 송경아, 효린X유라X미주와 ‘건강미 철철 넘치高’	MK스포츠
에프엑스 엠버, 건강미 넘치는 근황 ‘보일 듯 말 듯한 복근’	뉴스엔
하지원 팬사인회 성료, 밝은 미소와 건강미 과시	뉴스1
레드벨벳(RedVelvet) 조이, 건강미 넘치는 미모	웹데일리
이태임, 깜짝 놀랄 볼륨감..'슈퍼 건강미'	OSEN
조지아 로드리게스, 호날두 반하게 한 건강미…아기 엄마 맞아?	국제신문
공유, 건강미 넘치는 섹시한 여름 남자로 변신	이데일리
심으뜸, 선명 복근+탄탄 몸매 건강미甲 [똑똑SNS]	MK스포츠
정글의 법칙 유이…건강미 넘치는 ‘베이글녀’에 병만족도 그만…	헤럴드경제
선미 체중 증가, 건강미 위해…5kg 찌우기에 '24시간이 모자라'	경기일보
[포토엔]지헤라 ‘건강미 넘치는 탄탄한 각선미’(더쇼)	뉴스엔
[경향포토]엄정화, ‘건강미 넘치는 배우’	경향신문
치어리더 `건강미 넘치는 각선미` [MK포토]	MK스포츠
정아름-지나 '건강미 넘치는 보디라인'[포토]	엑스포츠뉴스
[E포토]NS윤지, 건강미 넘치는 섹시 복근	SBS funE
제바 '건강미 물씬'[엑's HD포토]	엑스포츠뉴스
고준희, 여름향기 물씬 풍기는 시원한 비주얼 “건강미 필수”[포토엔]	뉴스엔
성유리 모닝 요가, 얼굴에 몸매까지 완벽 그 자체! 건강미 제대로 뽐내	서울경제
[포토]'여자친구' 예린, 건강미 넘치는 꿀벅지	헤럴드POP
한채아, 건강미 빛나는 운동복 자태 '센 눈빛은 덤'	뉴스1
[포토] 화사, 건강미 넘치는 레드카펫	매일경제
'분위기 여신' 유이, 시크하면서 건강미 넘치는 여름 화보	enews24
옥타곤걸 데뷔 유승옥, `건강미 철철` [MK포토]	MK스포츠
조승희 '건강미 넘치는 등장'[엑's HD포토]	엑스포츠뉴스
박준형, 운동 자극하는 건강미 넘치는 뒷모습 ‘시선 스틸’	뉴스컬처
우주소녀 엑시, 건강미 넘치는 구리빛 피부 [MK포토]	MK스포츠
[스경포토] [머슬마니아] 임아로, 실력도 건강미도 최상급	스포츠경향
[N샷] 현아, 군살 제로 탄탄 몸매…건강미 뿜뿜	뉴스1
‘새신부’ 윤진서, 건강미 넘치는 하와이 화보	뉴스엔
군살 하나 없는 비키니여신 홍유진, 건강미와 매력이 철철 넘치죠[포토]	스포츠서울
[스경포토] [머슬마니아] 박지은, 건강미 발산	스포츠경향
요가 강사 박초롱 "이연희 닮은꼴…매일 아침 7시 40분 건강미 뽐내"	뉴스타운
[SS포토] 컴백 씨스타 효린 '건강미 넘치는 모습	스포츠서울
유이, 전문가 뺨치는 필라테스 실력 ‘건강미 철철’[SNS★컷]	뉴스엔
[스포츠경향 포토]낸시랭, 건강미가 담긴 뒤태	스포츠경향
“건강미 정석”…강예원, 플라잉요가 다시 시작했어요	스포츠조선
건강미 넘치는 조여정	연합뉴스
스타는 투잡중 이본, 탱크톱 입고 11자 복근 과시…건강미 폭발	MBN
[포토]건강미 넘치는 여자친구	헤럴드POP
'정글의법칙' 이태임, 건강미 넘치는 수영복 자태...'아찔+섹시'	스포츠조선
[e포토] ANS, 넘치는 건강미	enews24
건강미 뽐내는 피트니스웨어 패션쇼	연합뉴스
[스포츠경향 포토]‘머슬마니아’ 건강미의 향연	스포츠경향
신세경, 건강미 넘치는 피트니스 룩 화제	조선비즈
미스월드 브라질 최송이, 수영복 인증샷 "건강미 넘치는 구릿빛 피부"	헤럴드경제
남상미 `건강미 넘치는 발걸음` [MBN포토]	MBN
미스월드 브라질 최송이, 수영복 인증샷 "건강미 넘치는 구릿빛 피부"	헤럴드경제
남상미 `건강미 넘치는 발걸음` [MBN포토]	MBN
레이디티 임효라, ICN 코리아 그랑프리 입상..건강미 넘치는 몸매 '시선 집중...	서울경제
최여진, 건강미 넘치는 구릿빛 몸매	매일경제
[포토]'EXID' 하니, 건강미 넘치는 각선미	헤럴드POP
이엘, 건강미 넘치는 '굿바디'로 남심저격	스타데일리뉴스
[포토] 건강미 넘치는 치어리더의 응원전	서울신문
이상화, '건강미 넘치는 걸음'	서울경제
이하늬, 언더웨어 최장수 모델 기록…역시 건강미 지존	스포츠동아
[SS포토]보라, 건강미로 허벅지가(어 스타일 포 유)	스포츠서울
[포토엔]레드벨벳 ‘건강미 넘치는 각선미’(SBS 가요대전)	뉴스엔
하지원 `건강미 뽐내며` [MBN포토]	MBN
[포토] 건강미 넘치는 빅토리아 시크릿 패션쇼 모델	이데일리
문가비-션 `건강미 넘치는 아이콘` [MK포토]	MK스포츠
[경인포토]달샤벳, 건강미 넘치는 핫보디라인	경인일보
씨스타 비키니, 건강미 넘치는 '볼륨 S라인' 뽐내	머니투데이
[브릿지포토] 배우 이하늬, 영상을 통해 숨길 수 없는 건강미 발산	브릿지경제
고흥 '수호천사 건강미' 6년 연속 전남 10대 브랜드쌀	뉴스1
‘연극이 끝나고 난 뒤’ 윤소희, 운동하는 모습 “건강미 발산”	서울경제
하윤 `건강미 넘치는 각선미` [MK포토]	MK스포츠
강소라 '흰티에 청바지로 드러낸 건강미'[엑's HD포토]	엑스포츠뉴스
효연, 하와이 태양 아래 빛나는 미모 '청순&건강미' [화보]	엑스포츠뉴스
'건강미 넘치는 그녀'	뉴스1
[경인포토]김예림 쇼케이스, 건강미 넘치는 탄탄한 각선미	경인일보
[포토] 미스 비키니 후보들의 가려지지 않는 건강미	이데일리
김빈우, 건강미 뽐내며 찰칵 "빨리 동작하기보단 천천히 하려고 노력"	경상일보
[포토] SK 치어리더 '건강미 넘치는 응원'	스포츠조선
‘건강미 개그우먼’ 김혜선, 안소미 부케 받고 품절녀 예약[종합]	OSEN
[E포토]여자친구, 건강미 넘치는 무대	SBS funE
이하늬, 육감적이고 건강미 넘치는 속살 '화들짝'	일간리더스경제
더바디쇼 유승옥vs 더바디쇼 레이디제인, 건강미 대결 '승자는?'	한국경제TV
[포토] 혜리, '건강미 넘치는 발걸음~'	한국경제
[포토]씨스타 보라, 건강미 넘치는 비키니 화보	이데일리
[포토] 씨스타 효린 '건강미 돋보이는 구리빛 보디라인'	한국경제
이하늬, 건강미 가득 수영복 자태 빛나는 바디라인' [화보]	엑스포츠뉴스
유인영, 서퍼룩 선보이며 숨겨왔던 건강미 과시 [화보]	엑스포츠뉴스
'로드 트립' 컨셉 화보 촬영 엄현경 건강미 발산	국제신문
김희정, 스포츠웨어 모델 발탁 '건강미 대표주자'	엑스포츠뉴스
심형탁, 건강미 넘치는 속옷 화보…탄탄한 복근 '눈길'	머니투데이
효린 핫팬츠로 뽐낸 옆태, 건강미 넘치는 각선미	뉴스엔
효린 핫팬츠로 뽐낸 옆태, 건강미 넘치는 각선미	뉴스엔
걸스데이 혜리, 건강미 넘치는 화보 '탄탄한 복근'	엑스포츠뉴스
씨스타 보라-효린, `건강미 넘치는 섹시함` [MBN포토]	MBN
[포토] 건강미 넘치는 안유진	매일경제
'비결이 뭐예요?'..AOA 설현, 건강미 넘치는 보디라인 [화보]	한스경제
이하늬 화보 촬영...특유의 건강미 발산	국제신문
드레스입은 문정희, `감출수 없는 건강미` [MBN포토]	MBN
고흥 '수호천사건강미' 6년 연속 10대 브랜드쌀 선정	중도일보
브아걸 제아, 물오른 미모-건강미 넘치는 화보 공개	스포츠서울
고나은, 건강미 넘치는 일상 공개…애플힙과 성난 등근육 눈길	한국경제TV
"매혹의 눈빛"…정다래, 수영 여신의 건강미[화보]	헤럴드POP
'파격 시스루'…레이양, 건강미 넘치는 화보	엑스포츠뉴스
조여정, 여성지 표지모델로 '건강미+여성미' 발산	이데일리
[포토] 씨스타 보라, 건강미 넘치는 S라인	한국경제TV
[포토] 리아킴 '건강미 발산'	스포츠조선
[포토] 다이아 채연 '상큼함에 건강미까지 장착~'	스포츠조선
[포토] 서리나, '건강미 넘치는 그녀'	한국경제
옥주현, 62㎏ 체중 공개 후 필라테스로 다진 몸매…탄탄한 건강미	스포츠한국
[포토] 63세 머슬퀸 장래오, 꾸준한 운동 통해 얻은 건강미	디지털타임스
[포토] 달샤벳 수빈 '건강미 돋보이는 각선미'	한국경제
[HS포토] 화사, 건강미 넘치는 구릿빛 피부	한스경제
이하늬, 건강美 넘치는 일상 …"많이 웃는 주말 보내세요" [★해시태그]	엑스포츠뉴스
씨스타, 건강미 넘치는 비치 화보… 시선 강탈	스포츠동아
선미, 탱크톱 입고 복근 공개 '빼빼한 건강미'	enews24
'LPG 출신' 오다은, 아름다운 건강미	스포츠한국
[MD포토] 쯔위 '건강미 넘치는 미녀'	마이데일리
[포토]효린, 건강미 넘치는 '구릿빛 각선미'	헤럴드POP
영화'미옥' 김혜수, 블랙으로도 감출수 없는 건강미[SS포토]	스포츠서울
선미 체중 증가, 건강미 위해 살 찌워서 43kg? 말랐다..	충청일보
NS윤지, 살짝 드러낸 건강미	스포츠한국
NS윤지, 살짝 드러낸 건강미	스포츠한국
이시영, 탄탄 수영복 자태... 복서 출신의 건강미	TV리포트
[포토] 곽가현, 건강미 넘치는 각선미	서울경제
AOA, `하나같이 건강미 넘치는 각선미` [MBN포토]	MBN
"구릿빛 건강미"…효린, 걸크러시 돋는 비키니 자태	스포츠조선
[포토] 한수아, 건강미 넘치는 'S라인 시구'	브릿지경제
[포토] 페드벨벳 조이 '건강미 발산하며'	스포츠조선
최희, 건강미 넘치는 요가 화보 "S라인 살아있네"	헤럴드POP
'건강미 철철' 보라	연합뉴스
[스포츠경향 포토]‘피트니스스타’ 올해 최고 건강미는?	스포츠경향
‘미운우리새끼’ 한예슬 “나이 드니까 건강미 넘치는 스탈 선호"…김종국 母...	광주매일신문
효린 `건강미 넘치는 미소` [MK포토]	MK스포츠
[포토]'AOA' 초아, 건강미 넘치네!	헤럴드POP
건강미 자랑	연합뉴스
이효리 렌틸콩 조리법 공개, 건강미 넘치는 몸매의 비결?	MBN
클라라, "노출 아닌 건강미 추구, 업된 엉덩이 보여줄 생각만..." 발언 재조명	스포츠서울
[포토] 정아름, 건강미 넘치는 각선미	이데일리
[포토] 소녀시대 유리, 건강미 넘치는 각선미	서울경제
신수지 `샤킬오닐도 놀란 건강미` [MK포토]	MK스포츠
[포토] 보라, 건강미의 대명사	헤럴드경제
[포토] 소녀시대 유리, 건강미 넘치는 각선미	서울경제
신수지 `샤킬오닐도 놀란 건강미` [MK포토]	MK스포츠
[포토] 보라, 건강미의 대명사	헤럴드경제
[포토]`역대 최연소 FX Girl` 민시아, 넘치는 건강미	이데일리
전혜빈, 서퍼룩에 빛나는 선명한 복근 '넘치는 건강미'	마이데일리
배우 성훈 건강미와 신선함으로 글로우라우디 샴푸 모델 발탁	스포츠서울
'배구여제' 김연경, 건강미 넘치는 화보 공개…'탄탄 근육 시선집중'	엠스플뉴스
[포토]배그린 "운동으로 불면증 완전히 사라져"	이데일리
[스포츠경향 포토]박기량, 건강미 담긴 뒤태	스포츠경향
'남다른 섹시함'…제시, 구릿빛 건강미 과시	마이데일리
안다르, 기능·디자인 업그레이드 한 기모 레깅스 출시	매일경제
‘경이로운 소문’ 김세정, 악귀 감지율 100% 인간 레이더 변신 ‘기대감↑’	브레이크뉴스
씨스타 소유, `건강미 넘치는 미모!` [MBN포토]	MBN
[E포토]한채영, 건강미 넘치는 미소	SBS funE
[포토] 에이핑크 정은지, ‘건강미 발산 미소’	파이낸셜뉴스
[포토]박기량, 건강미 넘치게!	스포츠서울
MBN 건강미박람회 폐막…'건강·뷰티' 한자리에	MBN
최희, CF 촬영장서 상큼 발랄 체조 '건강미 발산'	한국경제TV
솔비 근황, 아찔 시스루 ‘속옷 노출’ 건강미 발산…누리꾼 “더 보기 좋아”	스포츠조선
솔비 근황, 시스루 옷 입고 건강미 발산 ‘달라진 외모’	매일경제
솔비 근황, 시스루 옷 입고 건강미 발산 ‘달라진 외모’	매일경제
[경인포토]효린, 건강미 넘치는 탄탄한 각선미 '눈길'	경인일보
[bnt포토] CLC 장승연 '넘치는 건강미'	bnt뉴스
[화보] 현아X제시, 연예계 섹시 아이콘의 건강미 '감탄'	부산일보
[포토]고우리, 수영복 화보 '건강미 발산'	이데일리
본분 금메달 경리, 몸무게 공개되면 어때?…건강미 과시	MBN
[포토] 건강미 넘치는 삼바 미녀의 유혹적인 눈빛	이데일리
한영, 건강미 넘치는 수영복 자태 공개…찍기만 해도 화보	지피코리아
윤현숙, 건강미 넘치는 각선미...40대 안 믿기는 인형 비주얼[★해시태그]	엑스포츠뉴스
유승옥, 남심 사로잡는 건강미-섹시미 발산	매일경제
유승옥, 남심 사로잡는 건강미-섹시미 발산	매일경제
제시카 복근·신세경 복근 "건강미 넘쳐" 감탄	경기일보
레드벨벳 조이, 건강미 넘치죠? [KBS 가요대축제]	MK스포츠
[E포토]제시, 건강미 넘치는 구릿빛 피부	SBS funE
유승옥, 남자 때려 눕히고 주먹질? 건강미 폭발 화끈 화보	마이데일리
[포토]머슬마니아 스포츠모델 쇼트 1위 류세비, 건강미 끝판왕	한국경제TV
전효성, 건강미 넘치는 잇몸미소 [MK포토]	MK스포츠
[포토] 씨스타 보라 '런웨이 사로잡은 건강미'	한국경제
"우유 한 팩보다 가볍다"…안다르 '뉴 에어웜 기모 지니 레깅스' 선봬	뉴스1
김유정, `건강미 넘치는 각선미` [MBN포토]	MBN
선미, 밀착 바이커 쇼츠+운동화 매치…건강미 '물씬'	머니투데이
'단발 변신' 전소미, 톡톡 튀는 건강미 담긴 반전 매력(화보)	스포츠서울
'파수꾼' 이시영, 마라톤 참가하며 건강미 발산	서울경제
[포토엔HD] 김희정 ‘건강미 넘치는 미모’	뉴스엔
배우 신민아, 쎌바이오텍 '듀오락' 모델로 건강미 뽐내	스포츠조선
(머슬마니아세계대회) 유승옥 '건강미 최고'[포토]	엑스포츠뉴스
[T포토] 이지애 '건강미 넘치는 미모'	TV리포트
건강미 뽐내는 헬스장 패션 '운동도 예쁘게'	뉴스1
[포토] 바다, '건강미 돋보이는 각선미'	스포츠조선
설현, AOA 컴백 티저 사진 공개 "건강미 넘치는 해양구조대"	헤럴드POP
'씨스타' 효린, 건강미 넘치는 얼굴!	서울경제
AOA 설현, 청순-건강미 넘치는 뷰티화보 공개	지피코리아
[포토] 보라 '섹시미와 건강미가 동시에'	스포츠조선
[포토] 치어리더, 건강미 넘치는 미모!	스포츠조선
‘건강미 가득’ 화사, 욕실서 톱브라·청바지로 뽐낸 글래머 몸매	세계일보
"개미허리+탄탄 몸매" 전소미, 건강미 넘치는 수영복 자태 [★SHOT!]	OSEN
[포토] 원지민, 넘치는 건강미	디지털타임스
[포토] 서지영, 구릿빛 건강미	디지털타임스
[포토] 이지현, 탄탄한 건강미	디지털타임스
'스타뎀의 그녀' 로지 헌팅턴 휘틀리, 건강미 넘치는 핫바디 [화보]	스포츠조선
[포토]신수지, 건강미 넘치는 S라인	헤럴드POP
출발드림팀 심으뜸, 태연 닮은꼴+건강미 넘치는 힙라인...비결은 '스쿼트 100...	전자신문
[사진] 2019 오토살롱위크,건강미 넘치는 모델	뉴스핌
MBN 건강미 박람회, '필록싱' 즐기면서 하는 운동이에요	시민의소리
[포토]'여자친구' 예린, 건강미 넘치네!	헤럴드POP
'♥차현우' 황보라 "아주 조금 걸어보았습니다..3만보" 넘치는 건강미	헤럴드POP
아이오아이(IOI), 건강미 넘치는 화보 공개 '국보급 각선미'	아주경제
"독보적 건강미"…이시영, 아침을 여는 미모[화보]	헤럴드POP
마마무 화사, 건강미 넘치는 매력 자태	뉴스1
효린, 건강미 넘치는 매력으로 뽐내... 화장품 광고까지 접수	민중의소리
"건강미 물씬"…'미스마' 윤송아, 무결점 몸매 [화보]	스포츠조선
현아-제시, 피트니스 화보 '건강미 발산'	이데일리
에일리 근황, 군살 없이 쭉 뻗은 다리…'건강미 넘쳐'	데일리한국
AOA 설현 ‘건강미 넘치는 핫팬츠 각선미’[포토엔HD]	뉴스엔
알리시아 비칸데르 '할리우드의 건강미 여신'[엑's HD포토]	엑스포츠뉴스
[TEN PHOTO]이진욱 '건강미 넘치는 구리빛 피부'	텐아시아
[포토]박신혜, 건강미 넘치는 각선미	아시아경제
인순이-정연, 건강미vs청순미 '선후배 함께하는 포즈'	뉴스1
고흥‘수호천사 건강미’ 5년 연속 대표 브랜드쌀 선정	이뉴스투데이
[건강미박람회] 셀리턴, LED마스크 체험	매경헬스
[건강미박람회] 입장전, 설레는 마음	매경헬스
[동아포토]있지 채령, 건강미 넘치는 입장	스포츠동아
[포토] AOA '이번 컨셉은 섹시미와 건강미의 결합	스포츠조선
'겟잇뷰티' MC 이하늬, 섹시 골반댄스 '건강미 폭발'	엑스포츠뉴스
‘정글의 법칙’정채연, 김동준"너무 예쁘다“ 청순미X건강미 물씬	헤럴드POP
AOA 초아, 티저 사진 '건강미 발산'	이데일리
'프리' 오정연, 골프 모델 발탁..숨겨왔던 건강미 발산	이데일리
'마리텔' 성소, 건강미 넘치는 서핑슈트 자태…화장실 발언에 '폭소	아시아경제
[건강미박람회] 셀티바, 모유유산균 제품 전시	매경헬스
상의 탈의 심으뜸, 건강미 넘치는 완벽 뒤태 자랑	국민일보
상의 탈의 심으뜸, 건강미 넘치는 완벽 뒤태 자랑	국민일보
선미 체중 증가, 컴백 앞두고 건강미 위해 '5kg 늘려'	엑스포츠뉴스
이하늬, 래시가드입고 명품몸매 자랑...건강미란 이런 것 [화보]	마이데일리
씨스타, 건강미 넘치는 하와이 비치 화보 공개	OSEN
지나, 조브하 래쉬가드 화보 B컷 공개…‘건강미+섹시미’	bnt뉴스
[사진]NTC끝낸 서효림,'건강미 발산'	OSEN
이하늬, 식물성 음료 새 모델 발탁 '건강미 통했다'	뉴스1
[포토]머슬마니아 이휘진 비키니, 건강미의 대명사	한국경제TV
'42kg→51kg' 배그린 파격 수영복 화보 "여자 김종국이라 불려"	한국경제
[e포토] 있지, 넘치는 건강미	enews24
[e포토] 있지, 넘치는 건강미	enews24
조보아, 건강미와 상큼함 동시 발산 ‘비타보아’ 등극	한국경제TV
'맨친' 유이, 다이빙 맹훈련..건강미 수영복 자태	스타뉴스
[포토엔HD] 트와이스 지효 ‘건강미 넘치는 각선미’(SBS가요대전)	뉴스엔
클라라, 건강미 넘치는 탄탄한 몸매 "마음의 균형 위한 노력" [★해시태그]	엑스포츠뉴스
[MD포토] 있지 류진, '넘치는 건강미'	마이데일리
‘마리텔’ 성소, 서핑슈트로 건강미 넘치는 S라인 공개 “너무 예뻐서 심쿵”	서울신문
[스포츠경향 포토]‘머슬마니아 화보 촬영’ 안인선, 건강미 담긴 밝은 미소	스포츠경향
황정서, 구릿빛 건강미 과시..피트니스 대회 사진 공개	파이낸셜뉴스
[포토] 김재경, 화려한 의상으로 ‘건강미 어필’	MBN
[포토] 김재경, 여름 화보 통해 ‘건강미 발산’	MBN
NS윤지, 화보B컷에서도 느껴지는 건강미	충청일보
빅토리아, 핫바디란 이런 것… 건강미 끝판왕!	스포츠동아
김아중, 군살 없는 수영복 자태…건강미 '물씬'	머니투데이
'아신부' 이시영, 탄탄한 건강미 발산 '매력만점'	엑스포츠뉴스
[포토]머슬마니아 비키니 1위 안인선, 건강미의 대명사	한국경제TV
소녀주의보 지성, 몸무게 덕에 래시가드 모델까지 ‘건강미 넘치는 육십돌’	전자신문
[스포츠경향 포토]머슬마니아 선발전, 최고의 건강미	스포츠경향
[포토] 마마무 화사 '건강미 넘치는 몸매'	스포츠조선
[스포츠경향 포토]이미도, 최고의 건강미	스포츠경향
포미닛 현아, 발리 비치 화보 공개..우월한 건강미 과시 ‘감탄’	한국경제
NS윤지, 건강미 물씬 러블리 서퍼…"시선 집중"	TV리포트
김지원 `건강미 돋보이는 무보정 각선미` [MBN포토]	MBN
[스포츠경향 포토]‘머슬마니아’ 수려한 건강미	스포츠경향
레반도프스키, 아내와 커플샷 클라스 '건강미'	파이낸셜뉴스
[스포츠경향 포토]‘머슬마니아’ 최설화, 건강미 한가득	스포츠경향
'인어전설' 오멸 감독 "전혜빈, '정글의 법칙'에서 건강미와 쾌활함 매력적"	헤럴드POP
[스경포토] [머슬마니아] 전혜빈, 최상급 건강미	스포츠경향
[스경포토] [머슬마니아] 오다은, 순백의 건강미	스포츠경향
설현, 달리기만 해도 떨어지는 섹시함 ‘건강미 발산’	스포츠서울
[스포츠경향 포토]‘머슬마니아’ 최설화, 뛰어난 건강미	스포츠경향
'인어전설' 오멸 감독 "전혜빈, '정글의 법칙'에서 건강미와 쾌활함 매력적"	헤럴드POP
[스경포토] [머슬마니아] 전혜빈, 최상급 건강미	스포츠경향
[스경포토] [머슬마니아] 오다은, 순백의 건강미	스포츠경향
설현, 달리기만 해도 떨어지는 섹시함 ‘건강미 발산’	스포츠서울
[스경포토] [머슬마니아] 김근혜, 미모·건강미 모두 갖춘 선수	스포츠경향
완전체 시크릿, 각선미가 장난 아니네! 단체 사진 속 건강미 눈길	스포츠조선
아빠는 딸 이미도, ‘볼륨+건강미’ 완벽 뒤태 “오랜만에 바닷가”	스포츠조선
김다솜 `건강미 넘치는 S라인` [MK포토]	MK스포츠
[포토] 이시영 '건강미 넘치는 초미니 패션'	스포츠조선
[포토] 이시영 '건강미 넘치는 초미니 패션'	스포츠조선
AOA 찬미, 설 특집 ‘머슬퀸 프로젝트’ 출연 확정..건강미 발산 예정	한국경제
‘미스코리아 위엄’ 이하늬, 건강미 넘치는 근황	한국일보
신세경 물구나무 "바들바들"…건강미 넘치는 S라인 몸매	뉴스1
`명품몸매` 제시카 고메즈, 넘치는 건강미	매일경제
[포토] 박기량, 건강미의 정석	스포츠경향
아프리카TV BJ서윤, 우월한 수영복 자태 '건강미 넘치는 볼륨감'	뉴스컬처
[포토엔]트와이스 쯔위 ‘건강미 넘치는 각선미’(SBS 가요대전)	뉴스엔
[bnt화보] 클라라 “건강미 부각되는 이미지 좋아, 더 노력하고 가꾸게 만들어...	bnt뉴스
치어리더 박윤혜 `건강미 넘치는 각선미` [MK포토]	MK스포츠
[포토] 혜리 '건강미 드러내는 한여름 패션'	스포츠조선
전효성 거울 셀카, 꿀벅지 공개…“건강미 넘쳐”	동아일보
[포토S] '미스 맥심' 꾸뿌, 건강미 뽐내며	스포티비뉴스
윤진서 비키니 요가, '섹시미+건강미' 탄탄한 보디라인 '눈길'	경인일보
[MD포토] 문정희 '건강미 넘치는 워킹'	마이데일리
'휠라 핏(FILA FIT)'-구세경 선수의 '섹시 건강미'	한국일보
'샤워 구조대' 이연, 건강미 발산 비하인드 컷 공개	부산일보
캡틴마블 브리라슨, 건강미 넘치는 수영복 자태 '시선강탈'	경인일보
SK 치어리더 `건강미 넘치는 미소` [MK포토]	MK스포츠
[포토] 네온펀치 백아 '건강미 넘치는 안무'	스포츠조선
[엑's HD] 치어리더 신수인 '건강미 넘치는 바디라인'	엑스포츠뉴스
[★포토]에일리, '건강미 넘치는 자태'	스타뉴스
BJ세제로, 건강미 넘치는 일상 공개 '여신 그 자체'	뉴스컬처
선미, 하늘색 미니 원피스 입고 미소…체중 증량으로 '건강미' 폭발 [SNS컷]	스포티비뉴스
[SW포토] 황승언, 건강미 넘치는 바디라인	스포츠월드
조여정, 건강미vs청순미 '극과극' 오가는 반전 매력	엑스포츠뉴스
에이핑크 손나은, 청순 벗고 탄탄 건강미 과시[화보]	스포츠동아
솔비, 건강미 넘치는 근황 공개…서울 패션위크 찾아	조선비즈
대자연 속 브라톱 차림으로 군살 하나 없는 몸매 뽐낸 유이…“건강미 넘쳐보...	세계일보
서효림, 도로 위 여름 여신 ‘건강미 발산’	SBS funE
마마무 화사, 구릿빛 건강미	스포츠한국
세계에서 가장 아름다운 여성 클라라, 건강미 넘쳐	엑스포츠뉴스
[포토]이서현, 건강미 넘치는 복근 과시	이데일리
[MD포토] 청하 '건강미 넘치는 라인'	마이데일리
소유, 건강미 넘치는 화보 공개	뉴시스
한솔 '건강미 최고'	뉴시스
다 가진 여자 이하늬, 래쉬가드 화보로 건강미 과시	스포츠서울
[머슬퀸 프로젝트] 이연 `건강미 뽐내며`	MBN
[포토] 에이핑크 손나은, ‘청순함에 건강미까지’	서울신문
[포토] 치어리더 원민주, 건강미 뿜뿜	스포츠서울
[포토] 에이핑크 손나은, ‘청순함에 건강미까지’	서울신문
[포토] 치어리더 원민주, 건강미 뿜뿜	스포츠서울
EXID, 5人5色 피트니스…건강미+섹시 동시 올킬 [화보]	스포츠동아
김진아, 작년 20대 못지않은 건강미 자랑했는데…	한국경제
예린 `건강미 넘치는 댄스` [MBN포토]	MBN
[화보]라붐 ZN-해인, 완벽 보디라인으로 건강미 과시	한국일보
[TEN PHOTO] 이윤선 '건강미 넘치는 몸매'	텐아시아
[포토] 달샤벳 수빈 '건강미 넘치는 댄스'	스포츠조선
[MD포토] 화사 '건강미 넘치는 구릿빛 피부'	마이데일리
양정원, ‘플레이어’ 출연에 관심↑…여전한 미모+건강미	환경일보
[포토] 네온펀치 '건강미 넘치는 등장'	스포츠조선
'최고의 연인' 김유미, 비하인드컷 공개 '건강미의 정석'	엑스포츠뉴스
[스타포토]AOA 설현, 시선강탈 진 화보 공개…'압도적 건강미' 발산	스포츠서울
[사진]이시영,'건강미 넘치는 매력'	OSEN
"건강미+청순" 치어리더 김한나, 맥심 5월호 표지모델 "인기 실감 안 나"	스포츠한국
건강미 넘치는 참가자	뉴시스
안다(ANDA), ‘벨리 버튼 챌린지’ 인증샷 공개..건강미 입증	텐아시아
[포토] 치어리더 '건강미 발산하는 댄스'	스포츠조선
[스포츠경향 포토]이지수 아나운서, 건강미를 담았어	스포츠경향
"건강미 通했다"...최여진, 스포츠 화장품 브랜드 전속 모델 발탁	텐아시아
"건강미 通했다"...최여진, 스포츠 화장품 브랜드 전속 모델 발탁	텐아시아
소이현, 만삭화보 공개…건강미 넘치는 당찬 예비맘	스포츠동아
"치명적 눈빛"…제시, 건강미 넘치는 섹시 자태	헤럴드POP
에이핑크 손나은, 화장품 록시땅 모델 발탁 "청순미 속 건강미"	텐아시아
신수지 `건강미 넘치는 어깨라인` [MK포토]	MK스포츠
치어리더 `건강미 넘쳐 흘러~` [MK포토]	MK스포츠
배우 김희정, 맥주 광고 모델 발탁 ‘건강미 어필’	헤럴드경제
[포토]문가비 '건강미의 아이콘'	헤럴드POP
[포토] 에이핑크 은지 '건강미 가득한 섹시 컨셉'	스포츠조선
"누가 건강미 넘치나"	연합뉴스
"누가 건강미 넘치나"	연합뉴스
[엑's HD] SK 치어리더 '건강미 발산'	엑스포츠뉴스
[포토] 에이핑크 보미 '건강미 넘치는 복근 노출'	스포츠조선
BJ씽잉, 건강미 넘치는 각선미 라인 '시선 강탈'	뉴스컬처
[★포토]지성 '육십돌의 건강미'	스타뉴스
고흥, '수호천사 건강미' 5년 연속 전남 대표 브랜드쌀 선정	뉴스타운
[포토] 소시 효연 '스키패션에도 건강미 발산'	스포츠조선
안다르, 마마무와 함께 ‘에어웜 기모 지니 레깅스’ 선보여	어패럴뉴스
박기량, 건강미 넘치는 명품 복근과 꿀벅지	스포츠동아
[e포토] 카드 전소민, 넘치는 건강미	enews24
고흥, '수호천사 건강미' 5년 연속 전남 대표 브랜드쌀 선정	뉴스타운
[포토] 소시 효연 '스키패션에도 건강미 발산'	스포츠조선
안다르, 마마무와 함께 ‘에어웜 기모 지니 레깅스’ 선보여	어패럴뉴스
박기량, 건강미 넘치는 명품 복근과 꿀벅지	스포츠동아
[e포토] 카드 전소민, 넘치는 건강미	enews24
AOA 찬미, 설 연휴 '머슬퀸 프로젝트'로 건강미 발산	OBS
씨스타, 흑백 화보 속 건강미 '내추럴해서 더 예뻐'	아시아경제
'언니' 배우 이시영 근황… 건강미 넘치는 일상샷 '상큼 미소'	경인일보
유리 '건강미 넘치는 바디라인'[포토]	엑스포츠뉴스
우주소녀 다영 ‘군살 無’ 건강미 넘치는 완벽 보디라인[SNS★컷]	뉴스엔
[bnt포토] 유승옥 '넘치는 건강미'	bnt뉴스
"이게 바로 명품 보디" 페이, 건강미 넘치는 화보 공개	스포츠서울
[포토] '솔비 근황' 건강미 하면 나지!	스포츠월드
[건강미박람회] 지방을 불태워라!	매경헬스
김연아, 화보 속 건강미 돋보이는 애슬레저룩 스타일링 눈길	쿠키뉴스
[포토] 보디라인 만큼 건강미 넘치는 미소	이데일리
바다, `건강미 넘치는 하객패션` [MBN포토]	MBN
'룸메이트' 송가연, 11자 복근 공개 '탄탄한 건강미'	머니투데이
레이양, 건강미 넘치는 수영복 자태…'군살 없는 몸매'	마이데일리
윤필용·김근혜, 건강미 넘치는 커플	스포츠한국
윤필용·김근혜, 건강미 넘치는 커플	스포츠한국
이태임 '건강미 넘치는 탄력 복근'[포토]	엑스포츠뉴스
"건강미 넘치는 몸매"...김소은, 2년 연속 란제리 브랜드 모델 발탁	텐아시아
황우슬혜, 건강미 돋보이는 초미니 [MK포토]	MK스포츠
[스포츠경향 포토]‘피트니스스타’ 여성 선수들의 건강미	스포츠경향
<비디오스타> 김숙-박나래, ‘챔피언도 인정한 건강미!’	MBC연예
씨스타, 건강미+몽환미 넘치는 'I LIKE THAT' 안무연습 영상 공개	충청일보
EXID 하니, 꿀복근 드러내며 건강미 과시 '완벽'	데일리안
씨스타 티저 공개 "건강미 넘치는, 사랑스러운 악녀들"	헤럴드경제
오정연, 골프 광고 모델 발탁 '건강미 눈길'	엑스포츠뉴스
20대 워너비 유인영, 서핑화보 통해 건강미 ‘발산’	아주경제
[스포츠경향 포토]홍주연, 건강미 넘치죠?	스포츠경향
샤킬오닐 `신수지, 건강미가 넘치네` [MK포토]	MK스포츠
[E포토]AOA,건강미 넘치는 그녀들의 무대	SBS funE
조여정, 건강미 돋보이는 화보 공개…탄탄한 근육, 무용수 못지않은 실력 ‘숨...	경기일보
[TEN PHOTO]한승연 '건강미 넘치는 각선미'	텐아시아
오하영, 탄탄한 건강미	스포츠한국
천이슬, 건강미 넘치는 운동 근황 공개 '복근은 덤'	뉴스컬처
올블랙 숙행, 남심 홀리는 건강미 넘치는 핫바디 '시선올킬'	위키리크스한국
'8kg 증량 후 건강미까지 얻은 선미'[엑's HD포토]	엑스포츠뉴스
천이슬, 건강미 넘치는 운동 근황 공개 '복근은 덤'	뉴스컬처
올블랙 숙행, 남심 홀리는 건강미 넘치는 핫바디 '시선올킬'	위키리크스한국
'8kg 증량 후 건강미까지 얻은 선미'[엑's HD포토]	엑스포츠뉴스
[포토엔]유승옥, 초미니로 드러낸 건강미 넘치는 각선미	뉴스엔
[경인포토]씨스타 효린, 건강미 넘치는 구릿빛 피부 '아찔'	경인일보
[포토] 치어리더 '시선 올킬하는 건강미'	스포츠조선
[SK포토]씨스타 효린, 건강미 넘치는 각선미	스포츠경향
개그우먼 류경진, `켠 김에 왕까지`에서 건강미 과시	게임메카
이효리, 건강미 넘치는 뒤태…불혹 앞둔 나이에도 믿을 수 없는 완벽 봄매	MBN
[T포토] 왕빛나 '건강미 넘치는 각선미'	TV리포트
[T포토] 왕빛나 '건강미 넘치는 각선미'	TV리포트
소녀시대 효연, 탄력 복근으로 뽐낸 건강미	TV리포트
맥스큐, 건강미 담긴 류세비 표지 화보 공개	스포츠경향
[포토] 안소정, 청순한 건강미	디지털타임스
[포토] 김가희, 구릿빛 건강미	디지털타임스
에너지 포뮬러 브랜드 '헬스헬퍼', 브랜드 새로운 얼굴로 배우 '김윤지' 발탁...	비지니스코리아
SBSCNBC '식객남녀' 정가은, 섹시 건강미 발산	SBS SPORTS
[포토] 힌트 '건강미가 넘쳐요'	스포츠조선
솔비 근황, 살짝 살이 오른 채 건강미 뽐내...과거 비키니 입고 완벽한 S라인...	헤럴드POP
걸그룹 글램, 수영복 모델로 발탁. 건강미 눈길	스포츠조선
건강미-청순미-섹시미, 클라라의 하의실종 스포티룩	스포츠조선
클라라, 건강미 넘치는 몸매 “명상으로 마음의 균형”	여성조선
헬로비너스 서영, `건강미 철철` [MBN포토]	MBN
씨스타 아이 스웨어(I Swear) 뮤비 공개, 건강미 '눈길'	스포츠한국
마이네임 인수, 농구 화보 공개 '활력 넘치는 건강미'	뉴스1
효린 꽃게, '효린 꽃게춤'이란?...다소 민망하지만 군살 하나 없는 단단한 허...	내외뉴스통신
헬로비너스 유영, 건강미 넘치는 미모	스포츠한국
한혜진, 속옷 화보 공개…"건강미 넘쳐"	머니투데이
f(x) 빅토리아, 건강미 넘치는 바디라인 공개	한국경제TV
소유, 앉아만 있어도 화보...건강미 넘치는 각선미	스포츠서울
[포토] '전우치' 유이, 건강미 넘치는 웃음!	스포츠조선
[포토] 모델 구성현, 건강미 넘치는 바디	뉴데일리
현대인 위한 에너지 포뮬러 브랜드 '헬스헬퍼'…배우 김윤지 모델 발탁	데일리그리드
[TEN PHOTO] 레이양 '건강미 넘치는 미소'	텐아시아
[오마이포토] '마마무' 솔라, 빈 틈없는 건강미	오마이뉴스
김준희, '건강미 폭발' 각선미 자랑 "164cm 키에 53kg 몸무게"	공무원저널
유승옥, 건강미 넘치는 섹시 화보 공개… "포토샵 보정 하지말라"	경인일보
나르샤, 건강미 넘치는 수영복 화보 공개 '시선강탈'	Queen
[포토] 씨스타 효린, 변함없는 건강미	매일경제
공효진 오리발, 깡 마른줄 알았는데 건강미 넘치는 11자 각선미	충청일보
이효리 '건강미' 여전하지!	한스경제
[포토S] 강예빈, 건강미 넘치는 몸매	스포티비뉴스
[엑's HD] 서우희 '건강미 넘치는 S라인'	엑스포츠뉴스
[포토] 치어리더 '탄탄한 건강미 발산'	스포츠조선
이미란, '건강미 넘치는 몸매과시~'(쎄라퀀비키니쇼 어워즈)	뉴스타운
우주소녀 연정, 건강미 넘치게~ [포토엔HD]	뉴스엔
오연서, 수영복 화보 속 건강미 발산…잘록한 허리 '시선 강탈'	머니투데이
건강미 뽐내는 맹은영	뉴시스
선미, 몸무게 50kg 달성 인증샷 보니… '건강미 물씬'	메트로신문
신수지, 패션지 화보에서 운동으로 다져진 건강미 발산	스포츠경향
선미, 몸무게 50kg 달성 인증샷 보니… '건강미 물씬'	메트로신문
신수지, 패션지 화보에서 운동으로 다져진 건강미 발산	스포츠경향
클라라 시구 해명, ‘건강미 보여주고 싶어 레깅스 직접 골라…’	서울경제
[포토] 건강미 넘치는 웃음, 에이핑크 나은	뉴데일리
고흥군 ‘수호천사건강미’, 6년 연속 전남 10대 브랜드쌀 선정	뉴스웨이
[포토] 바다, 매력 넘치는 건강미!	스포츠조선
엠카 AOA, `건강미 넘치는 허벅지` [MBN포토]	MBN
에이핑크 정은지, 역시 자기관리 끝판왕..건강미 넘치는 근황	헤럴드POP
[사진]에이핑크 손나은,'건강미 넘치는 트레이닝 패션'	OSEN
배그린 "43kg→51kg, 절친 박신혜 조언이 내 인생 바꿨다" [화보]	스포츠조선
김빈우, 군살 하나 없는 건강미..다이어트 효과 제대로	헤럴드POP
서효림, 건강미 넘치는 매끈 S라인 돋보여	스포츠월드
[포토] 치어리더 '건강미 넘치는 복근'	스포츠조선
[★해시태그] "운동 데이트"...미나♥류필립, 건강미 넘치는 매력	엑스포츠뉴스
[SS포토] 달샤벳 수빈, 건강미 넘치는 꿀벅지	스포츠서울
[TEN PHOTO] 엄지원 '건강미 위해 태닝만 17번'	텐아시아
씨스타 팬 사인회, 상큼발랄 건강미 넘치는 아웃도어 패션	충청일보
가희, `건강미 넘치는 구릿빛 각선미` [MBN포토]	MBN
[오마이포토] '터치 마이 바디' 씨스타, 넘치는 건강미	오마이뉴스
[★포토]소유, '건강미 넘치는 각선미'	스타뉴스
[포토] 양승화, 구릿빛 건강미	디지털타임스
솔비 근황, 수영장서 건강미 과시 ‘가슴 보일락 말락’	데일리안
[E포토]김종국, 오늘도 건강미 넘치는 웃음	SBS funE
‘마리텔’ 우주소녀 성소, 건강미 넘치는 서핑수트 자태 ‘눈길’	서울경제
[포토] '미스 섹시백' 건강미 넘치는 애플힙	한국경제
[포토] 이예진, 넘치는 건강미	디지털타임스
[포토] 박지우, '건강미 넘치는 바디~'(AFIC 비포앤애프터)	뉴스프리존
문가비 '건강미 넘치는 구릿빛 꿀벅지'	마이데일리
[포토엔]에이핑크 윤보미 ‘건강미 넘치는 핫팬츠 각선미’	뉴스엔
건강미 뽐내는 여성들	뉴스1
건강미 뽐내는 여성들	뉴스1
[bnt영상] 신수지, ‘건강미X섹시미’ 넘친 화보 현장 공개!	bnt뉴스
[포토] 씨스타 보라-소유 '건강미 돋보이는 각선미'	한국경제
[포토] 지스타2018 '건강미 넘치는 포즈'	스포츠조선
솔비 근황, 통통하게 오른 볼 살 ‘건강미 넘치는 얼굴’	MBN
최송현, 크로아티아 요트 셀카 '건강미 물씬'	엑스포츠뉴스
AOA ‘심쿵해’ 라커룸 티저 공개…섹시+건강미 ‘팔색조 매력’	bnt뉴스
이일화, 20대를 능가하는 건강미	스타데일리뉴스
'우아한 D라인'…소이현, 건강미 넘치는 만삭화보 공개	엑스포츠뉴스
[포토] 양정원, 건강미 넘치는 몸매	스포츠조선
한채아, 운동 중인 근황 공개..'동안 피부+건강미' 눈길	이데일리
[드림콘서트] 시크릿, `건강미 넘치는 뒤태`	매일경제
한국 '플레이보이' 폴 댄서 바다의 건강미 넘치는 화보 눈길	스포츠서울
이하늬, '건강미 넘치는 화보' 공개	스타데일리뉴스
[문화포토] 이소희 '탄력넘치는 건강미'	문화뉴스
[화보] 이일화, 절제된 섹시함으로 ‘시선강탈’…20대 능가하는 건강미	스포츠경향
하니 `건강미 넘치는 위아래` [MBN포토]	MBN
설현, 복근 드러내고 도심 속 러닝…건강미에 ‘시선집중’	스포츠동아
송수현 `미코 선의 건강미 넘치는 몸매` [MK포토]	MK스포츠
이효리, 제주도 사로잡은 건강미..민박집에서 만나요~	스타뉴스
렉시 톰슨 '건강미 넘치는 각선미'[포토]	엑스포츠뉴스
전지현 화보, 건강미 넘치는 탄탄 몸매	농업경제신문
[e포토] 우주소녀, 넘치는 건강미	enews24
김혜수, 보는 순간 빠져드는 '건강미'	시사포커스
[건강미박람회] 가누다, 기능성 베개 체험존	매경헬스
브아걸 제아, 원조 센언니의 섹시 건강미 [화보]	마이데일리
'아육대' 리듬체조 금메달 위엄, 차오루 건강미 넘치는 화보	헤럴드POP
[E포토]씨스타, 건강미 넘치는 그녀들의 무대	SBS funE
치어리더 `건강미 과시하는 허벅지` [MK포토]	MK스포츠
김유정, 발랄한 테니스걸 변신 ‘건강미 넘치는 자태’[포토엔]	뉴스엔
김유정, 발랄한 테니스걸 변신 ‘건강미 넘치는 자태’[포토엔]	뉴스엔
AOA, 16일 새 앨범 ‘굿 럭’ 발매…건강미 물씬 해상구조대 변신	NSP통신
현아, 눈 돌아가는 탄탄복근 “건강미↑”	TV리포트
한혜진, '인티모 더 테니스' 화보 공개…건강미 '물씬'	머니투데이
[포토] 나인뮤지스 손성아 '건강미 넘치는 뒤태'	스포츠조선
[T포토] 마마무 화사 '넘치는 건강미'	TV리포트
`황이모` 황인선, 건강미 넘치는 각선미 [MK포토]	MK스포츠
[화보] 강예원, 건강미 넘치는 S라인…‘섹시 서핑룩’ 완성	매일경제
[스포츠경향 포토]낸시랭, 탄탄한 복근으로 건강미 발산	스포츠경향
윤진서, 화보로 남성팬 유혹 '섹시미 or 건강미'	enews24
사유리, 건강미 넘치는 모습 공개…”운동하기 딱 좋은 날씨“	헤럴드경제
건강미 넘치는 효린	노컷뉴스
[포토] 스텔라 가영, '건강미 넘쳐'	세계일보
[스포츠경향 포토]‘머슬마니아’ 소유하고픈 건강미	스포츠경향
[Oh!쎈 컷] "스포티 건강미"..레이디스코드 애슐리, 솔로 티저 공개	OSEN
[스포츠경향 포토]‘머슬마니아’ 류은혜, 바리스타의 건강미	스포츠경향
[포토]'핫바디' 정아름, 쭉 뻗은 다리 '건강미 물씬'	이데일리
[스포츠경향 포토]‘머슬마니아’ 김은영, 슬림 탄탄한 건강미	스포츠경향
[포토] 윤보라 '건강미 넘치는 매력'	스포츠조선
[경인포토]조여정, 구릿빛 피부서 느껴지는 건강미… 고개만 까딱해도 男心 흔...	경인일보
[스포츠경향 포토]‘머슬마니아’ 류은혜, 바리스타의 건강미	스포츠경향
[포토]'핫바디' 정아름, 쭉 뻗은 다리 '건강미 물씬'	이데일리
[스포츠경향 포토]‘머슬마니아’ 김은영, 슬림 탄탄한 건강미	스포츠경향
[포토] 윤보라 '건강미 넘치는 매력'	스포츠조선
[경인포토]조여정, 구릿빛 피부서 느껴지는 건강미… 고개만 까딱해도 男心 흔...	경인일보
[포토엔]달샤벳 세리, 건강미 넘치는 보디라인(달샤벳 쇼케이스)	뉴스엔
지나, 탄탄한 허리라인 드러내고 건강미 과시	뉴스1
홍수아, B컷 맞아? 세련미에 건강미까지 '쭉 뻗었네'	마이데일리
효린, B컷 화보 공개..섹시 & 건강미	OSEN
레이양, 건강미 넘치는 운동복 자태 '탄탄'	엑스포츠뉴스
[포토엔]달샤벳 세리, 건강미 넘치는 보디라인(달샤벳 쇼케이스)	뉴스엔
지나, 탄탄한 허리라인 드러내고 건강미 과시	뉴스1
홍수아, B컷 맞아? 세련미에 건강미까지 '쭉 뻗었네'	마이데일리
효린, B컷 화보 공개..섹시 & 건강미	OSEN
레이양, 건강미 넘치는 운동복 자태 '탄탄'	엑스포츠뉴스
변정수, 40대 맞아? 건강미 넘치는 몸매 [똑똑SNS]	MK스포츠
[포토] 카라 박규리, 건강미 넘치는 복근	서울경제
[화보] 한보름, 걸크러시 뿜뿜..건강미 ‘그레잇’	OSEN
[건강미박람회] 고대안암, 좌식탈피 캠페인 펼쳐	매경헬스
‘출발 드림팀2’ 레이양, 청순 미녀의 반전 매력? 건강미 발산에 ‘시선집중...	MBN
윤진서, 건강미 넘치는 그녀!	서울경제
조여정, 초콜릿 등근육 공개..청순미에 섹시미·건강미까지 “다 가진 배우”	헤럴드경제
소유, 완벽한 자태 뽐내는 건강미	시사포커스
[포토엔]황우슬혜 ‘건강미 넘치는 핫팬츠 각선미’(혼술남녀 종방연)	뉴스엔
브레이브걸스, 구두 대신 운동화…건강미 넘치는 머슬퀸 컴백	뉴스1
[스경포토] [머슬마니아] 전혜빈, 빈틈 없는 건강미	스포츠경향
신세경 '안다르' 레깅스 패션 공개…건강미 넘치는 화보컷 '눈길'	아주경제
[스경포토] [머슬마니아] 오다은, LPG 전 멤버의 건강미	스포츠경향
건강미 뽐내는 여성 피트니스 선수들	연합뉴스
최정원, 건강미 넘치는 미모	스포츠한국
에밀리 라타이코프스키, 산책하며 드러난 건강미 [포토화보]	스포츠동아
'대세남' 박서준 질스튜어트 스포츠 티저 건강미 폭발	스포츠서울
'더쇼' 브레이브걸스, 건강미가 흘러 넘치는 무대	뉴스1
[사진]안다,'건강미 넘치는 보디라인'	OSEN
"심쿵해 반해버렸어"…AOA, 섹시 건강미 넘치는 해상구조대 티저	마이데일리
솔비, 서울패션위크서 근황 공개…건강미 넘치는 모습	조선비즈
임지혜, 섹시함과 건강미 묻어나는 '비키니샷' 공개	엑스포츠뉴스
[포토]정지훈 '넘치는 건강미'	헤럴드POP
[E포토]브레이브걸스, 건강미 넘치는 헬스걸	SBS funE
[MD포토] 에이핑크 정은지, '건강미 넘치죠?'	마이데일리
'청량미UP·건강미UP'..'볼륨 퀸' 시선 강탈한 걸그룹 루이	세계일보
씨스타 ‘I Swear’ 영상, 건강미 곳곳에 콸콸	스포츠동아
[포토] 나오미 해리스, 오렌지 컬러 드레스로 건강미 뽐내	이데일리
[포토] 씨스타 보라 '건강미 돋보이는 S라인'	한국경제
코카콜라. 식후비법 더블유W차 + 유인나 화보 공개	조세일보
신봉주 '건강미 뽐내며'	뉴시스
최성원, 건강미 넘치는 복근 화보… 네티즌 "어서 빨리 회복을…"	시사위크
[건강미박람회] 애경, 잇몸케어 2080 치약 증정	매경헬스
[사진]한솔,'건강미 물씬'	OSEN
[e포토] 드림캐쳐 다미, 넘치는 건강미	enews24
[e포토] 드림캐쳐 다미, 넘치는 건강미	enews24
[포토엔HD] 이리나 샤크, 좌우 다 봐도 건강미 넘치는 보조개 미소	뉴스엔
[스포츠경향 포토]‘2017 머슬마니아’ 이연화, 남다른 건강미	스포츠경향
[스포츠경향 포토]‘머슬마니아’ 강연지, 남다른 건강미	스포츠경향
[포토] 달샤벳 수빈 '건강미 강조한 하의실종'	스포츠조선
아이즈원 야부키 나코, 넘치는 건강미 [MK포토]	MK스포츠
전혜빈 란제리 화보, 건강미 넘치는 '탄력바디' 눈길	머니투데이
'레깅스가 찰떡'…베리굿 조현, 건강미 넘치는 하체	마이데일리
선미 50kg 달성→물오른 건강미…누리꾼 응원 “섹시+귀염 다 갖춘 선미”	MBN
[사진]이시영,'건강미와 섹시함이 가득'	OSEN
[e포토] 오하영, 넘치는 건강미	enews24
'나혼산' 박나래, 폭소 주의보..폭풍 흡입 다이어터	스타뉴스
[사진]이연화,'건강미 뽐내며 손하트'	OSEN
[포토] 씨스타 보라, '건강미하면 제가 빠질 수 없죠'	한국경제TV
아이오아이, 소녀들이 선보이는 '건강미' 넘치는 화보… 순수+발랄	데일리한국
유인영, 서핑 화보… ‘숨길 수 없는 특급 건강미야!’	스포츠동아
바다, `건강미 넘치는 탄력 각선미` [MBN포토]	MBN
씨스타 소유 `건강미 넘치는 보디라인` [MBN포토]	MBN
[사진]체리블렛 유주, '멀리서도 시선 사로잡는 건강미'	OSEN
[사진]낸시랭,'섹시 건강미 뽐내며'	OSEN
‘평균 60kg’ 소녀주의보 지성, 광고계 러브콜 “건강미 적합”	OSEN
한보름, 건강 섹시美…B컷 공개 [화보]	스포츠동아
강소리, 탄탄한 건강미로 어머니 팬심 공략	스포츠동아
[경인포토]씨스타 효린, 건강미 넘치는 바디라인 '아찔해'	경인일보
[스포츠경향 포토]‘2015 머슬마니아’ 동안의 건강미	스포츠경향
[포토] 다니엘 헤니-이시영 '건강미가 느껴지네'	한국경제
[MD포토] 정채아 '건강미 넘치네'	마이데일리
씨스타 보라, 건강미 넘치는 S라인	서울경제
[포토] 선미, '건강미 넘치는 아름다움'	한국경제
[포토] 치어리더 '건강미 넘치는 복근 과시'	스포츠조선
[포토] 선미, '건강미 넘치는 아름다움'	한국경제
[포토] 치어리더 '건강미 넘치는 복근 과시'	스포츠조선
[T포토] 홍진영 '건강미 넘치는 각선미'	TV리포트
엄현경, 남다른 건강미 발산…청순 미모에 반전 몸매	한국경제TV
[스경X화보] 머슬마니아 이휘진, 무용으로 다져진 ‘건강미 아우라’	스포츠경향
[포토] 건강미 뽐내는 그룹 베베헬	매일경제
‘아름다운 나의 신부’ 이시영, 건강미 가득한 비하인드 컷 공개	헤럴드POP
[포토] 공서영, '섹시한 건강미 당당하게'	스포츠조선
건강미 뽐내는 여성 보디빌더	뉴스1
'건강미 여신' 강소라 '건강의 비결은 걷기'[엑's HD포토]	엑스포츠뉴스
모모랜드 연우 ‘건강미 넘치는 각선미~’ (INK 2018) [포토엔HD]	뉴스엔
남규리 수영복 화보, 청순 글래머 건강미 과시 '고혹'	한국경제TV
조현아, 건강미 넘치는 각선미 [MK포토]	MK스포츠
[뷰티한국]윤진서, 건강미 넘치는 탄탄한 바디라인 공개	한국일보
양정원, 마리텔의 새로운 강자…건강미·섹시미로 첫방부터 1위	아시아경제
유선, 건강미 넘치는 각선미 [MK포토]	MK스포츠
NBA 치어리더, `건강미 넘치는 모습` [MK포토]	MK스포츠
‘건강미를 담은 아름다움’ 손태영, 당당한 여신 이미지 TV CF 첫 공개	MBC연예
박신혜 관악산 등산, 건강미 넘치는 미소 "즐거운 주말"	OBS
안다르, 2020 F/W 마마무 새 화보 공개!	비욘드포스트
홍지민, `건강미 뽐내며` [MBN포토]	MBN
[포토]'8개월만의 컴백' AOA, 건강미로 중무장!	헤럴드POP
"리즈 갱신"…선미, 8kg 증량 후 물오른 미모+건강미	마이데일리
미스코리아 진 김진솔, 건강미 기품 갖춘 우월 외모	전자신문
손연재 오션월드 광고 스틸컷 공개... 건강미 자랑	뉴데일리
[T포토] 옥주현 '하트가 건강미 넘쳐'	TV리포트
[포토]'나인뮤지스' 혜미, 건강미 넘치네!	아시아경제
배우 이슬비, 건강미 발산하며 운동 셀카 공개!	스포츠서울
건강미 넘치는 유승옥	노컷뉴스
[스포츠경향 포토]이나영, 선을 살린 건강미	스포츠경향
[스포츠경향 포토]‘피트니스스타’ 여성 선수들의 남다른 건강미	스포츠경향
[포토] 씨스타 효린, 건강미 넘치는 각선미!	OBS
[사진]섹시백 대상 김하늘,'섹시와 건강미가 넘치는 뒤태'	OSEN
CLC 장승연 '건강미 물씬'[엑's HD포토]	엑스포츠뉴스
열정과 패기로 건강미를 뽐낸 2019 나바 WFF 아시아 오픈 챔피언쉽 대회	뉴스타운
'건강미 물씬' 채은정, 운동으로 가꾼 탄력적인 보디	스포츠서울
경리 '건강미 넘치는 S라인'[엑's HD포토]	엑스포츠뉴스
뮬라웨어 이하늬 모델로 발탁 건강미 뿜뿜	국제신문
이효리, 호주 브리즈번서 매혹적인 화보…'소길댁'의 건강미	국제신문
한혜진, 건강미 넘치는 몸매로 시선강탈 "군살은 허용불가"	데일리안
한혜진, 건강미 넘치는 몸매로 시선강탈 "군살은 허용불가"	데일리안
'컴백' 이효리, 건강미 넘치는 핫 보디 화보 공개	스타데일리뉴스
[SK포토]씨스타 효린, 끊임없이 드러나는 건강미	스포츠경향
[건강미박람회] 심으뜸 애플힙 만들기	매경헬스
파파야 고나은, 운동 셀카…건강미 과시	MBN
‘정글의법칙’ 물 만난 유리, 건강미 넘치는 반전 등근육 ‘깜짝’	한국경제TV
건강미 뽐내는 피트니스웨어	노컷뉴스
건강미 뽐내는 헬스장 패션	노컷뉴스
장멍제, 건강미 넘치는 그녀! “나는 운동 마니아”	인민망
[포토] 우주소녀 연정 '건강미 넘치는 미모'	스포츠조선
소유 `건강미 넘치는 각선미` [MK포토]	MK스포츠
타히티, 신곡 '알쏭달쏭' 2차 티저 공개 '건강미+섹시미'	뉴스1
[포토] 김정화, 건강미 넘치는 하트	시사포커스
바바라 팔빈, 속옷 화보 공개…"건강미 넘쳐"	머니투데이
여성들의 워너비 이하늬, 건강미 넘치는 화보로 ‘시선강탈’	MBN
'해피투게더4' 좋은 풍채가 건강미 있어 보이는 거다...	인천일보
여자친구 예린, 넘치는 건강미 [골든디스크]	MK스포츠
[포토] 신수지, 볼륨 보디라인에서 건강미 `물씬`	이데일리
[E포토]AOA, '건강미 넘치는 각선미'	SBS funE
가수 미소(Miso), 건강미 넘치는 '핫 보디라인' 과시	뉴스타운
'윤종신♥' 전미라, 175cm 넘사벽 9등신 비율…"이제 민소매는 안녕"	스포츠조선
“건강미 폭발” 김재경-NS윤지, 비키니보다 섹시한 래쉬가드[포토엔]	뉴스엔
[포토] 건강미 뽐내는 비키니 미녀	매일경제
코카콜라 더블유W차, 배우 유인나 광고 비하인드컷 공개	국민일보
"명불허전 섹시퀸" 이효리,언더웨어화보서 건강미#제주도#요가#나이듦	스포츠서울
"거의 체벌" 조병규, 열혈 운동 삼매경..♥김보라 반한 건강미	헤럴드POP
[포토] 소녀시대 수영 '건강미 묻어나는 브이~'	스포츠조선
[건강미박람회] 체력왕을 향해 달린다!	매경헬스
[★포토]유빈, 넘치는 건강미!	스타뉴스
김정화 `건강미 넘치는 옆라인` [MK포토]	MK스포츠
김정화 `건강미 넘치는 옆라인` [MK포토]	MK스포츠
배그린 "운동? 하루 3시간 기본.. 여자 김종국으로 불려"	이데일리
건강미 대명사 이시영 올여름 광고여신 예감	스포츠서울
[포토] 유선, '건강미 넘치는 그녀'(소비자의 날 시상식)	한국경제
[포토] 효연 '건강미 넘치는 꿀벅지'	스포츠조선
[뉴스핌 포토] '허삼관' 하지원, 건강미는 내가 최고!	뉴스핌
'PMC' 하정우 "이선균의 따뜻함과 건강미, 사람들이 좋아하는 이유"	조이뉴스24
효린, 건강미 넘치는 몸매로 '한국의 비욘세' 인증	데일리안
선미, 여름 강타할 美친 건강미…시크+섹시 폭주 [화보]	스포츠동아
(머슬마니아세계대회) 유승옥 '건강미 넘치는 보디라인'[포토]	엑스포츠뉴스
(머슬마니아세계대회) 유승옥 '건강미 넘치는 보디라인'[포토]	엑스포츠뉴스
"발끝까지 완벽"..가희, 출산 후 되찾은 건강미[화보]	헤럴드POP
수빈, 운동 욕구 유발 환상 옆라인...래시가드 입고 건강미 발산	enews24
루나 `건강미 넘치는 미소` [MBN포토]	MBN
AOA ,'하트어택' 재킷서 라크로스선수로 '건강미' 발산	스포츠서울
추성훈♥야노시호 화보, 건강미에 스타일까지 잡았다[포토엔]	뉴스엔
[포토]이수경, 건강미 넘치는 섹시 서퍼처럼	이데일리
김세아, 건강미 돋보이는 완벽 필라테스 자태 [화보]	엑스포츠뉴스
시크엔젤 유희, 래시가드 입고 시원한 건강미	스포츠경향
'오늘부터 사랑해' 임세미, 건강미 넘치는 인증샷 '유연성 과시'	OBS
유이 다이빙, 건강미 돋보이는 ‘꿀벅지’… 감탄!	동아일보
씨엘, 감출 수 없는 섹시한 건강미.."헐리우드 스타들과 좋은 기억"	스타뉴스
한혜진 언더웨어 화보, 독보적인 건강미…복근 '탄탄'	머니투데이
[포토엔HD] 김희정 ‘건강미 선보이며 미소’	뉴스엔
명품 건강미 뽐내는 문지영	뉴시스
나인뮤지스 출신 박민하, 밀착 레깅스 입고 탄탄한 건강미 과시	스포츠경향
한채아, 스포츠 브랜드 모델 발탁 '건강미 인증'	뉴스핌
‘정은우와 결별’ 박한별, 근황 살펴보니…화장기 없는 민낯으로 건강미 과시	MBN
‘아이언 레이디’ 윤소희, 건강미 넘치는 운동 스틸 컷 공개	아주경제
꿀벅지 유이, 어깨라인 드러내 '건강미 종결자'	머니투데이
한채아, 절세미녀 벗고 스포츠 여신으로 변신..'건강미 발산'	세계일보
하지원, `건강미 넘치는 각선미` [MBN포토]	MBN
레드벨벳(REDVELVET) 조이, '건강미 넘치는 자태' (2018 소리바다어워즈)	서울경제
애슐리 "건강미 더한 섹시함..스포티한 매력 차별화"	스타뉴스
건강미 뽐내는 '브레이브걸스' 하윤	뉴시스
[포토] 미소도 건강미 넘치는 배우 강소라	뉴데일리
[포토] 건강미 넘치는 어벤져스2의 수현	뉴데일리
[오마이포토] '터치 마이 바디' 씨스타, 건강미하면 효린!	오마이뉴스
[포토엔]에일리 ‘건강미 넘치는 각선미’	뉴스엔
유인영, 인형 외모에 건강미 추가..완벽 수영복 패션	OSEN
전혜빈, 건강미의 대명사...여성들 사이에서 '핫'아이콘 떠올라	스포츠조선
정글의 법칙 유승옥, 정글에서 발산된 건강미…꿀벅지로 코코넛나무 타기 대성...	MBN
[포토] 이본 '탄탄한 건강미'	스포츠조선
남궁민 홍진영 우결 합류, 환상의 조합… “건강미가 넘치네!”	동아일보
'택시' 홍수아, 고난도 필라테스도 척척…건강미 넘치는 '볼륨몸매'	스포츠조선
천이슬, 건강미 물씬 화보 "몸매에 자신감 생겼다"	엑스포츠뉴스
[포토] '미스 섹시백' 건강미 넘치는 뒤태	한국경제
[bnt포토] 김보강 '건강미 넘치는 구리빛 피부'	bnt뉴스
낸시랭, 유승옥·이연의 `머슬마니아` 준비? PT로 건강미 드러내	이데일리
[포토] 유슬아, 건강미 넘치는 보디라인	이데일리
[스포츠경향 포토]신다원, 우월한 건강미	스포츠경향
[포토]홍수아, 구릿빛 피부에 잔근육까지 '건강미 표본'	이데일리
안다,K2화보서 풋풋한 건강미 "현빈선배님과 만남 기대돼"	스포츠서울
"이 몸매 실화?" 배우 김다솜, 건강미 뽐내는 명품 보디라인	한국경제
브레이브걸스 "머슬퀸 콘셉트, 여성미·건강미 강조"	엑스포츠뉴스
"빨간 쉬폰드레스 흩날리며" 손태영, 고혹+건강미 폭발 광고	enews24
[포토엔]소녀시대 유리 ‘건강미 넘치는 구릿빛 각선미’	뉴스엔
모유 먹고 건강미 뽐내는 아이들	뉴스1
은하 `건강미 과시` [MK포토]	MK스포츠
[MD포토] 치어리더 박소진, '건강미 가득한 몸매'	마이데일리
은하 `건강미 과시` [MK포토]	MK스포츠
[MD포토] 치어리더 박소진, '건강미 가득한 몸매'	마이데일리
어느 멋진날 AOA 스포티룩, 건강미가 물씬	스포츠경향
[포토] 레이싱모델 한리나 '건강미 넘치는 각선미'	한국경제
[포토]'베스티' 유지, 건강미 넘치네!(스타24시)	아시아경제
한혜진, 누드 화보로 건강미 "5月 뷰티-헬스책 발매"	enews24
[MD포토] CLC 장승연, '건강미 넘치는 각선미'	마이데일리
[포토] 미스 파라과이, 비키니로 건강미 발산..매혹적인 걸음	이데일리
김아중, 건강미 넘치는 화보 공개	아시아경제
‘진짜 사나이2’ 이시영, 수수한 민낯 속 빛나는 건강미 “체력이 국력”	스포츠경향
[사진]서효림,'운동복으로 드러낸 건강미'	OSEN
이하늬, 건강미 넘치는 뒤태 자랑 [MK포토]	MK스포츠
[런던포토] 건강미 넘치는 비치발리볼 선수들	스포츠조선
방송인 안선영이 만삭 사진 공개하며 "세상의 모든 엄마들께 응원을 보낸다"고...	허프포스트코리아
이하늬, 이것이 건강미다..'꿀피부' 화보	스타뉴스
자신과 싸워 만든 건강미	뉴스1
소녀시대 유리-비비안, 비키니 화보 공개 “볼륨감+건강미” 심쿵	서울신문
한선화 “2020 봄 첫” 등산 중에도 예쁨 ‘건강미 스타’ [SNS★컷]	뉴스엔
클라라 해명 "건강미 보여드리려고 했는데…"	아주경제
김준희, 트렌드한 수영복 입고 '건강미 발산'	이데일리
김준희, 트렌드한 수영복 입고 '건강미 발산'	이데일리
[포토] 우주소녀 성소 '단연 돋보이는 건강미'	스포츠조선
'화신' 클라라 시구패션 해명 "건강미 보여주고 싶었다"	뉴스핌
전혜빈, 화보 B컷 통해 완벽 바디라인 과시 ‘역시 건강미 대표 아이콘’	한국경제
[포토] 뉴욕 `로켓츠`, 무용으로 다져진 건강미 뽐내	이데일리
유승옥·최여진, 건강미 넘치는 보디라인.."자심감 중요"	스타뉴스
[bnt포토] 차예련 '건강미 넘치는 각선미'	bnt뉴스
'미스맥심' 스카일라, 맥심 화보 공개..비키니로 구리빛 건강미 과시	이데일리
[포토] 허은, `김준호 클래식 2017` 위해 건강미 드러내	이데일리
[포토]이유리, 음악 즐기며 건강미 발산	이데일리
소이현 임신해도 변치않는 '초특급 미모'…건강미 '철철'	SBS funE
베리굿 서율, 시선을 사로잡는 건강미…‘드림팀’ 출연 위해 운동 중	한국경제TV
[스포츠경향 포토]이미도, 건강미 넘치는 각선미	스포츠경향
아이오아이(I.O.I), 첫 완전체 화보 공개… 소녀 이미지 어디로? ‘건강미 넘...	서울신문
[ET-SNS] NS윤지, 휴양지 속 건강미 넘치는 근황 공개 "Goooood morning"	전자신문
건강미 넘치는 섹시한 뒤태 미인	뉴스1
달샤벳 ‘맨즈헬스’ 화보 공개…상큼하게, 때론 건강미 넘치게	아시아경제
[스포츠경향 포토]‘머슬마니아’ 건강미 담은 ‘스마일걸’	스포츠경향
[스포츠경향 포토]‘머슬마니아’ 낸시랭, 완벽한 건강미	스포츠경향
[스포츠경향 포토]‘머슬마니아’ 건강미 우승자는 누구?	스포츠경향
[스포츠경향 포토]‘머슬마니아’ 귀여운 얼굴 가진 건강미	스포츠경향
"건강미 넘치는 보디라인" 효린, 섹시미로 시선 집중	스포츠서울
[포토]레아 미셀, 건강미 넘치는 포즈	이데일리
류화영, 건강미 넘치는 각선미(손의 흔적)	서울경제
CLC 장승연, 건강미 넘치는 구리빛 피부 [MK포토]	MK스포츠
[스포츠경향 포토]‘머슬마니아’ 이미영, 헤어디자이너의 건강미란	스포츠경향
(동영상) AOA 티저, 라커룸서 건강미 넘치는 스트레칭	뉴스1
[포토] 달샤벳 세리 '건강미 물씬 풍겨요'	스포츠조선
[스포츠경향 포토]머슬마니아 선발전, 야구 여신의 건강미 안타	스포츠경향
오정연, 골프 브랜드 모델 발탁...꾸준히 가꿔온 건강미 과시 '시선 집중'	스포츠조선
[스포츠경향 포토]‘머슬마니아’ 이수인, 천연조미료 같은 건강미	스포츠경향
(동영상) AOA 티저, 라커룸서 건강미 넘치는 스트레칭	뉴스1
[포토] 달샤벳 세리 '건강미 물씬 풍겨요'	스포츠조선
[스포츠경향 포토]머슬마니아 선발전, 야구 여신의 건강미 안타	스포츠경향
오정연, 골프 브랜드 모델 발탁...꾸준히 가꿔온 건강미 과시 '시선 집중'	스포츠조선
[포토] 있지 채령 '건강미 넘치는 각선미'	세계일보
지니 11자 복근 vs 서현 11자 복근, 女아이돌도 건강미 시대	bnt뉴스
[스포츠경향 포토]‘머슬마니아’ 최설화, 흠 잡을 곳 없는 건강미	스포츠경향
[경인포토]소녀시대 유리, 건강미 넘치는 구릿빛 각선미	경인일보
[bnt포토] 모모랜드 연우 '매력만점, 건강미'	bnt뉴스
[bnt포토] 모모랜드 연우 '매력만점, 건강미'	bnt뉴스
AOA 설현, 청순 미모+건강미 담은 뷰티 화보 공개	서울와이어
[화보] I.O.I, 소녀 티 벗고 건강미 발산 ‘반전 매력’	스포츠경향
"이렇게 섹시했었나"..신지, 건강미 넘치는 다리 각선미	헤럴드POP
한채아, 스포츠 여신 등극…'건강미 발산'	엑스포츠뉴스
UFC 홀리 홈, 건강미 넘치는 미모	한국경제TV
[포토] 모델 채보미, 건강미 담긴 각선미	스포츠경향
[포토] 효린, 건강미 넘치네'	서울경제
[포토]클라라 "건강미 부각되는 이미지 좋아"	이데일리
치어리더 배수현, 건강미 넘치는 몸매 [MK포토]	MK스포츠
치어리더 배수현, 건강미 넘치는 몸매 [MK포토]	MK스포츠
[포토]김유정, 스포티룩으로 건강미 UP	헤럴드POP
[포토] 전효성 '건강미가 제 매력'	스포츠조선
"건강미 넘치는 뒤태"…이효리, 단연 돋보이는 섹시 카리스마	마이데일리
컴백 달샤벳, '너 같은' 뮤직비디오 보니 복싱-테니스…'건강미 발산'	헤럴드POP
비키니 피트니스는 여성 건강미·섹시미 동시 연출	매일신문
‘섹시 파이터’로 변신…인혜빈, 건강미 넘치는 화보 공개	서울신문
조보아, 넘치는 상큼+건강미 발산..역시 ‘인간 비타민’	파이낸셜뉴스
레이양 착시 보디 수트… 건강미 과시	신아일보
[사진]설현,'건강미 넘치는 미소'	OSEN
스카일라, 핫핑크 언더웨어 화보..건강미 과시	스타뉴스
우주소녀 '너에게 닿기를' 퍼포먼스 버전 뮤비 '건강미 발산'	이데일리
[포토] 치어리더 '건강미 넘치는 복근 방출'	스포츠조선
김경화, 보디슈트로 뽐낸 건강미..."매끈하게 만져주셔서 감사"	매일경제
박기량 치어리더, 아이콘택트 출연해 리더로서 일침 "건강미가 없다"	증권경제신문
[문화포토] 씨스타 보라 '건강미 넘치는 미소'	문화뉴스
[사진]삼성생명 치어리더, '건강미 뽐내며'	OSEN
'오늘부터 사랑해' 임세미 건강미 넘치는 모습으로 시선 집중	부산일보
[SK포토]‘더 바디쇼’ 최여진, 건강미로 입장	스포츠경향
클라라-줄리엔강, 워터파크 모델로 나서 건강미 `케미` 보여줘	이데일리
“몸매 비결은 러닝?”…리즈 위더스푼, 건강미 넘치는 매력 [포토화보]	스포츠동아
포미닛 허가윤 `건강미 넘치는 복근` [MBN포토]	MBN
'나홀로 연애중' 잭슨, 유리와 가상 데이트 "건강미 넘치는 여자 좋아"	한국경제TV
[스경포토] [머슬마니아] 최윤희, 군살 제로 건강미	스포츠경향
[포토]보라-효린 '건강미 넘치는 시크女'	이데일리
[스경포토] [머슬마니아] 민홍희, 미모·건강미 모두	스포츠경향
[스경포토] [머슬마니아] 류세비, 최상급 건강미	스포츠경향
루나 설리, SM타운 행사서 빛낸 물오른 미모…건강미 VS 청순미 폭발	MBN
"독보적 건강미"…이하늬, 강렬한 비치룩[화보]	헤럴드POP
[AG포토] 씨스타 '건강미는 금메달'	스포츠조선
루나 설리, SM타운 행사서 빛낸 물오른 미모…건강미 VS 청순미 폭발	MBN
[스경포토] [머슬마니아] 전지원, 건강미 담긴 뒤태	스포츠경향
"독보적 건강미"…이하늬, 강렬한 비치룩[화보]	헤럴드POP
[AG포토] 씨스타 '건강미는 금메달'	스포츠조선
[스포츠경향 포토]이소희, 건강미의 정석	스포츠경향
클라라 해명 “레깅스 시구, 이슈 아닌 건강미 보여주기 위해…”	MBN
EXID 하니, `건강미 넘치는 각선미` [MBN포토]	MBN
[NC포토] 미쉘 위 '건강미 넘치는 보디라인'	뉴스컬처
박형식 옆 임지연, `건강미 넘치는 각선미` [MBN포토]	MBN
AOA, 건강미 넘치는 그녀들~ (2016슈퍼서울드림콘서트)	서울경제
[간밤TV] ‘마리텔’ 성소, 건강미 넘치는 서핑슈트 자태	스포츠경향
양정원, 남성지 ‘맥심’ 표지 장식···건강미+섹시미 ‘폭발’	서울경제
치어리더 박소진 `건강미 넘치는 구리빛 피부` [MK포토]	MK스포츠
손연재, 이 다리길이 실화냐? 공항을 레드카펫으로 만든 건강미 여신	enews24
김연정 `건강미 넘치는 댄스` [MK포토]	MK스포츠
'주먹이운다' 송가연 복근 공개, 건강미 넘치는 몸매로 '여신파이터 강림'	충청일보
[★화보] 설현, 건강미 넘치는 몸매 '에너지 뿜뿜'	머니S
[사진]이소연,'건강미 넘치는 모습으로'	OSEN
한고은, 4년차 유부녀의 건강미 넘치는 일상 “요거트 한 잔”	뉴스엔
[포토] 립서비스 '건강미 복근 자랑하며'	스포츠조선
씨스타 touch my body로 휴가철 테마송 노린다…건강미 과시	MBN
손나은, 청순 매력 속 건강미 발산	시사포커스
“다시, 흑진주” 소녀시대 유리, 건강미의 정석 [화보]	TV리포트
헐리웃 여배우 수현의 숨막히는 건강미 "근육량 10kg 늘었다"	스포츠조선
AOA, 신곡 '굿 럭' 티저 영상 공개…해변 위 섹시미+건강미 발산	아주경제
씨스타 소유, 건강미 넘치는 화보 공개 "실물이 훨씬 괜찮죠?"	충청일보
[SW포토] 조윤희, 탄탄한 꿀벅지…건강미 넘치네	스포츠월드
[DAY컷] 안신애,日사진집 오늘 발매…男心 뒤흔들 빛나는 건강미	스포츠동아
[스포츠경향 포토]‘머슬마니아’ 그랑프리, 이연화의 건강미	스포츠경향
[경인포토]'어 스타일 포유' 보라, 건강미 넘치는 구릿빛 피부	경인일보
[포토] 디홀릭 '섹시한 건강미 발산'	스포츠조선
[스포츠경향 포토]최미진, 건강미·날씬함 모두 잡았어	스포츠경향
오윤아, 건강미 넘치는 우월 미모	한국경제TV
"해변의 머슬녀"…유승옥, 독보적 건강미	스포츠조선
"반전 건강미"…천이슬, 11자 복근 깜짝 공개	스포츠조선
레이양, 건강미 넘치는 하의실종 화보 공개	스타뉴스
"라인에 감탄"..효린, 돋보이는 건강미	헤럴드POP
[경인포토]씨스타 쇼케이스 효린, 건강미 넘치는 구릿빛 피부	경인일보
치어리더 최미진, 건강미 넘치는 ‘매력’ 복근	국민일보
[MD포토] 건강미와 섹시미를 동시에	마이데일리
[TEN PHOTO]위너 이스훈 '건강미 넘치는 구리빛 피부'	텐아시아
[스포츠경향 포토]‘2015 머슬마니아’ 건강미와 우아함	스포츠경향
조여정 건강미, '정글의 법칙' 덕분? 섹시한 구릿빛 피부 '눈길'	bnt뉴스
김소은, 여성 건강 전문 브랜드 새 뮤즈 발탁	한국경제TV
여자친구 예린, `짧은 무대의상으로 드러낸 건강미` [스타포토]	디지털타임스
[TEN PHOTO]레이디스코드 애슐리 '건강미 넘치는 무대'	텐아시아
[HD+] 이하늬, 래쉬가드 화보로 건강미 발산	스타데일리뉴스
[사진]건강미 넘치는 日 치어리더	OSEN
이수정·강예빈, 한국 UFC 옥타곤걸…건강미+섹시미 갖춰	엑스포츠뉴스
NS윤지, 밀착 원피스 입고 뽐낸 ‘건강미’	채널A
NS윤지, 밀착 원피스 입고 뽐낸 ‘건강미’	채널A
[포토]씨스타 '건강미로 중국을 흔들어라'(FCC2016)	아시아경제
[포토] 그룹 베베헬, 건강미로 인기몰이	매일경제
'맥스큐' 창간 9주년 수영장 화보 大방출 '섹시+건강미' 눈길	스타뉴스
[포토] 아놀드 슈왈제네거, 세월 거스르는 건강미	헤럴드경제
금나나, 수영복 자태에 ‘깜짝’…“미스코리아 眞의 건강미”	동아일보
‘베이글녀’ 설현, 시선강탈 진 화보 공개…압도적 건강미 발산	한국경제TV
`퀸` 손담비, 스포츠화보로 건강미+섹시미 과시	이데일리
"건강미 뽐내고 500만원에 도전"…MBN '건강미 영상 콘테스트' 6월2일까지	MBN
‘내일은 시구왕’ 성소, 건강미 폭발 춘리 시구로 ‘최종 우승’	서울경제
유리 `건강미 넘치는 각선미` [MK포토]	MK스포츠
치어리더 `건강미 돋보이는 각선미` [MK포토]	MK스포츠
개그우먼 출신 장경희 결혼, 단아함 격파…건강미 드러낸 웨딩화보	스포츠동아
이하늬, 래쉬가드 화보..밝은 미소+건강미 `심쿵`	이데일리
TS착한치약, 단아하고 건강미 넘치는 배우 이하늬 모델로 발탁	스포츠서울
김사랑 `건강미 뽐내는 각선미` [MK포토]	MK스포츠
로드걸 이은혜 `건강미 넘치는 몸매` [MK포토]	MK스포츠
마이네임 인수, 화보 통해 남다른 농구 실력 뽐내...건강미 ‘물씬’	한국경제
[TEN PHOTO]빅뱅 대성 '건강미 넘치는 피부'	텐아시아
[MD포토] 정유승 '돋보이는 건강미'	마이데일리
유이, 건강미 넘치는 모습…비욘세 뺨치는 ‘꿀벅지’	스포츠동아
임지연, 역대급 먹방으로 건강미 과시	동아일보
뜨겁게 달아오른 건강미의 제전 '피트니스스타 안산'대회	뉴스타운
설현 맥스무비 화보, 건강미 넘치는 섹시한 매력 '물씬'	머니투데이
윤보라, 건강미 넘치는 바디라인 "체육돌의 위엄"	데일리안
[포토] `아카데미 시상식` 실베스터 스탤론, 건강미 넘치는 아내와 함께	이데일리
클라라 해명, 시구 이유 건강미 보여주려고 "잘 보이기 위한 것"	충청일보
이하늬, 숨길 수 없는 건강미 '탄탄'	데일리안
루나, 과감한 한뼘 비키니로 건강미 물씬 "Summer"[★SNS]	enews24
[포토] 건강미 넘치는 김유정	매일경제
[포토] 건강미 넘치는 김유정	매일경제
‘플랜맨’ 은지원, 박나래 건강미에 “브록레스너 같다”	MBN
‘건강미 담당’ 나뮤 경리, 뷰티프로 MC 됐다…손태영 호흡	TV리포트
[SK포토]씨스타 효린, ‘내가 바로 건강미의 여왕’	스포츠경향
[2017 MAMA] 이하늬, 절개 드레스 입고 ‘건강미 발산’	스포츠동아
[포토]화영, 아령 들고 건강미 뽐내	이데일리
[스포츠경향 포토]‘피트니스스타’ 여성 선수의 건강미 담긴 허벅지	스포츠경향
[포토] 전효성, 잘록한 허리라인으로 건강미 과시	매일경제
에이핑크 정은지, 멋스러운 애슬레저룩…건강미 '폭발'	머니투데이
티아라 함은정, 체지방 10kg 감량… “건강미 넘치네!”	스포츠동아
티아라 함은정, 체지방 10kg 감량… “건강미 넘치네!”	스포츠동아
AOA, '굿 럭' 위크버전 티저 공개… 건강미·섹시 보디라인 눈길	스포츠월드
AOA 초아, 스냅백 완벽 소화 '건강미 발산'	엑스포츠뉴스
NS윤지 근황, 건강미 넘치는 '탄탄 복근' 공개	머니투데이
치어리더 배수현 `건강미 넘치는 미소` [MK포토]	MK스포츠
[화보] 진세연, 섹시+건강미 넘치는 화보 ‘신비로운 여인’	스포츠경향
가희 복근, 王자 새겨질 기세 ‘건강미 넘쳐!’	스포츠동아
[TEN PHOTO]민지 '건강미 넘치는 구리빛 피부'	텐아시아
‘나 혼자 산다’ 소유, ‘탄력 허벅지’ 건강미 최고 ‘수상스키 실력은?’	스포츠조선
한채아, 완벽 운동복핏으로 건강미 발산 '스포츠 여신'	마이데일리
3월 대선 앞둔 푸틴, 얼음목욕하며 건강미 과시	이데일리
[경인포토]전효성 쇼케이스, 건강미 넘치는 섹시함 '제가 보여드릴게요'	경인일보
[경인포토]전효성, 건강미 넘치는 탄탄한 각선미 '시선집중'	경인일보
가요대제전 에일리 효린 제시, 가슴 뚫리는 사이다 무대 "건강미 넘쳐"	한국경제TV
인순이, 나이잊은 건강미에 '관객 열광'..보디빌더대회 출전	스타뉴스
숀리 해명 "조여정, 송혜교 통통 아니라 건강미다"	머니투데이
[포토] 하늘 향해 치솟은 엉덩이와 탄탄한 허벅지..건강미 물씬	이데일리
[화보]건강미 넘치는 그녀들 '씨스타 쇼타임' 제작발표회 현장	경인일보
'나 혼자 산다' 박나래, 다이어터 모드 돌입.. 독보적 텐션으로 안방극장 접수	MBC연예
씨스타 'I Swear' 뮤비만 봐도 섹시·건강미 넘치네	스포츠월드
김연경, '매력적인 건강미' (2017 올해의 브랜드 대상)	서울경제
[포토엔]씨스타 ‘건강미 넘치는 매력’	뉴스엔
[건강미박람회] 북적이는 체력왕 선발대회	매경헬스
우주소녀 성소 `건강미 넘치는 복부` [MBN포토]	MBN
신세경, 블랙야크 모델 발탁…래시가드입고 건강미 보여주나	마이데일리
정가은, ‘반전 드레스’로 섹시 건강미 발산	스포츠동아
'해피투게더' 김종국 "건강미 있는 여자 좋아"…채연vs윤은혜 중 선택은?	조세일보
한소아, 강남 프로 복싱 대회 모델 선정…'건강미 넘쳐'	전자신문
[포토]수영 '넘치는 건강미'	헤럴드POP
[건강미박람회] 100세 시대 치아 관리 이렇게	매경헬스
[건강미박람회] 스트레칭 기구로 '척추 건강'	매경헬스
[현장포토] “배꼽이 빼꼼”…오하영, 군살제로 건강미	디스패치
[건강미박람회] 암치료 상담하는 참관객들	매경헬스
[포토] 가수 바다, 건강미 넘치는 입장	매일경제
[포토엔]안다 ‘건강미 넘치는 각선미’	뉴스엔
(머슬마니아세계대회) 정겨운 '건강미 넘치는 꿀벅지'[포토]	엑스포츠뉴스
헬로비너스 위글위글 댄스 화제…건강미 넘치는 보디라인 ‘남심 매료’	MBN
[인터뷰③] 유이 "'꿀벅지' 시절 나도 그리워..건강미 회복 노력"	스포츠조선
[포토엔]소녀시댕 유리 ‘건강미 넘치는 구릿빛 피부’	뉴스엔
[건강미박람회] 개막식 기다리는 참관객들	매경헬스
[건강미박람회] 개막식 기다리는 참관객들	매경헬스
김새롬, 비오템 화보로 건강미 뽐내	bnt뉴스
[건강미박람회] 티젠, 12가지 유산균 더한 콤부차 선보여	매경헬스
달샤벳, 테니스 화보 '건강미 물씬'	이데일리
[SW포토] 아이오아이, 첫 완전체 화보… 건강미 넘치는 소녀들	스포츠월드
선미, 몸무게 50kg 돌파 인증샷 공개.."건강미 넘쳐"	F.E타임스
[★포토]유빈, 건강미 넘치는 매력	스타뉴스
[건강미박람회] “뒷목을 쭉~” 균형 바디 OK	매경헬스
[포토] 김연아, '건강미 넘치는 그녀~'	한국경제
윤아 11자 복근, 섹시미에 건강미까지 '완벽녀'	경기일보
[bnt포토] 씨스타 효린 '건강미 돋보이는 핫바디'	bnt뉴스
[SK포토][멜론 뮤직 어워드] 건강미의 정석, 씨스타	스포츠경향
녹용의 효능, ‘건강미 甲’ 정아름 비키니 몸매에도 관심 폭발	MBN
피트니스로 다져진 명품 건강미	뉴시스
[포토] 오마이걸 유아 '건강미 넘치는 하의실종'	스포츠조선
‘엄마의 근육’ 배은주, 남다른 건강미로 눈길	스포츠경향
유이, 건강미 실종…너무 마른 몸 (2016 MBC 연기대상)	스포츠한국
<포토> 클라라의 건강미 넘치는 수영복	헤럴드POP
'제10회 MBN 건강미박람회' 관람객 이벤트 미리보기	매경헬스
[NTN포토] 하지원 '건강미 넘치는 각선미'	서울신문
[동아포토]소녀주의보 지성, 건강미	스포츠동아
윤보라, 건강미 넘치는 몸매에 도전장은 내민 강자는?	데일리안
[포토] 씨스타 '건강미 넘치는 미모'	파이낸셜뉴스
남궁민 홍진영 우결 합류, 건강미 커플… “어떤 모습 보여줄까?”	동아일보
김혜진 '건강미 넘치는 뒤태 공개'[엑's HD포토]	엑스포츠뉴스
포미닛 소현, '쎄씨' 화보서 우월한 건강미 자랑	시사위크
브레이브걸스 은지, 건강미 넘치는 포즈	뉴시스
소유,건강미넘치는 핫보디 "건강에 좋은 음식과 자세교정운동"	스포츠서울
[포토] '미스 섹시백' 건강미 넘치는 섹시 뒤태	한국경제
[경향포토]〈관능의 법칙〉엄정화, ‘건강미 넘치는 배우’	경향신문
[MD포토] 이시영 '남다른 건강미 발산'	마이데일리
대표 베이글녀 신세경의 건강미 넘치는 화보	헤럴드POP
[SS포토] 효린, 건강미 넘치는 걸음	스포츠서울
[포토] 씨스타 보라 '건강미 돋보이는 포즈'	한국경제
[포토엔]엄정화 ‘건강미 넘치는 근육질 각선미’	뉴스엔
[스포츠경향 포토]최설화, 수줍은 건강미란	스포츠경향
진세연, 건강미 넘치는 도도+신비 눈빛	OSEN
NS윤지 컴백, 건강미 돋보이는 비키니 자태에 ‘시선 집중’	스포츠동아
크리에이터 오늘의 하늘, 완벽 보디라인..러블리한 건강미[화보]	헤럴드POP
'8kg 증량' 선미, 건강미 넘치는 꽃받침 셀카 [★해시태그]	엑스포츠뉴스
미주 이 정도면 걸그룹 원톱 몸매 '건강미 발산'	브릿지경제
조보아 건강미 흠뻑	한라일보
글램디, 건강미 넘치는 설현 화보 공개	머니S
'강남♥' 이상화, 헬스장 셀카 공개 '넘치는 건강미' [★해시태그]	엑스포츠뉴스
산다라박 건강미, 복근 운동복+아령 '의욕 충만'	OBS
김현중 흑백 화보, 건강미 넘치는 복근 '감탄'	머니투데이
<LA 마라톤>건강미 넘치는 선수들	뉴시스
WBFF, 최고의 건강미는?	연합뉴스
이유비 `건강미 넘치는 경례` [MK포토]	MK스포츠
[포토]씨스타, 섹시한 건강미로 돌아왔다	헤럴드POP
[포토]씨스타, 섹시한 건강미로 돌아왔다	헤럴드POP
예인 '건강미를 맡고 있습니다'	연합뉴스
한고은, 연하 남편 반하게 할 수밖에 없는 건강미	브릿지경제
'더쇼' AOA·씨스타 빅매치 전격비교… '섹시 건강미vs발랄 건강미'	경인일보
[NW포토]‘더 바디쇼’ 유승옥, 건강미에 섹시미 추가요~!	뉴스웨이
'나 혼자 산다' 박나래, 진동 댄스부터 파워 워킹까지 독보적인 매력	헤럴드POP
[★포토]조현, '건강미 넘치는 각선미'	스타뉴스
최송현, 크로아티아서 미모 과시 '건강미 물씬'	엑스포츠뉴스
'미녀골퍼' 유현주 프로, 건강미 가득 넘치는 콜라병 몸매 주목	뉴스컬처
'옥타곤걸' 강예빈-이수정-유승옥, 서구에도 밀리지 않는 독보적 '건강미'	스포츠조선
'옥타곤걸' 강예빈-이수정-유승옥, 서구에도 밀리지 않는 독보적 '건강미'	스포츠조선
한혜진, 건강미 넘치는 비키니 자태… 시선 올킬	스포츠동아
[포토] 소시 유리 '건강미 넘치는 여배우로 변신'	스포츠조선
체리블렛 유주, 건강미 돋보이는 각선미 [포토엔HD]	뉴스엔
'명품몸매' 최여진, 속옷화보서 건강미 과시	이데일리
제시, 섹시 매력 시선 집중..."건강미 넘치는 섹시미"	스페셜경제
[포토] EXID 하니 '건강미 돋보이는 각선미'	한국경제
김준희 굴욕없는 보디라인…건강미 발산	헤럴드경제
[브릿지포토] 에이핑크 정은지 '건강미 뿜뿜'	브릿지경제
고준희 "건강미 필수, PT+필라테스 병행 중" [화보]	TV리포트
고준희 "건강미 필수, PT+필라테스 병행 중" [화보]	TV리포트
엑소 카이 "하루에도 수십 번씩 무대하고 싶다고 생각"[화보]	스포츠조선
이하늬, 숨막히는 래쉬가드 화보 공개…'진정한 건강미란 이런 것!'	시사위크
[포토]미스 캐나다, 댄스스포츠 의상으로 건강미 드러내	이데일리
[포토] 미스 케이맨아일랜드, 화이트 비키니로 건강미 자랑	이데일리
[포토] 우주소녀 보나 '건강미 넘치는 각선미'	세계일보
[포토] 미스 오스트레일리아, 건강미 넘치는 비키니 보디라인	이데일리
제시, 넘사벽 건강미 자랑하며 "유럽 기다려"	헤럴드POP
‘오늘부터 사랑해’ 임세미, 건강미 넘치는 비하인드 컷 공개	스포츠경향
건강미 넘치는 근육을 봐주세요	뉴스1
[포토] 손연재, 반전 건강미 뽐내며 섹시함까지 더해	스포츠월드
'기계체조 선수 출신' 안지혜, 건강미 넘치는 미소![엑's HD포토]	엑스포츠뉴스
구구단 초근접 촬영 티저, 9명 소녀들의 건강미	뉴스엔
[포토] 유승옥, '남심 자극하는 건강미'	뉴스프리존
[스포츠경향 포토]이시영, 건강미를 담은 블랙 드레스	스포츠경향
차예련, 건강미 넘치는 각선미	스포츠한국
미스 섹시백, 건강미 돋보이는 뒤태	뉴스1
건강미 뽐내며	뉴스1
[스포츠경향 포토]‘머슬마니아’ 낸시랭, 눈길 끄는 건강미	스포츠경향
[스포츠경향 포토]‘머슬마니아’ 동안 얼굴 가진 건강미 실루엣	스포츠경향
[스포츠경향 포토]‘머슬마니아’ 동안 얼굴 가진 건강미 실루엣	스포츠경향
(2015머슬마니아) '섹시한 건강미 넘치는 선수들'[포토]	엑스포츠뉴스
(2015머슬마니아) 송해주 '심쿵하게 만드는 건강미'[포토]	엑스포츠뉴스
[bnt포토] 조민수 '건강미 넘치는 자태'	bnt뉴스
[포토] 수영, 건강미 넘치는 미소	매일경제
[포토] 노규오, '예쁨과 건강미가 동시에'(2019 미스그린코리아)	뉴스프리존
머슬퀸 레이양, 제주 완벽 S라인으로 역대급 건강미 발산	부산일보
[사진]나인뮤지스 금조,'섹시에 건강미까지'	OSEN
[포토] 윤다연, 세계 대회 출신 다운 건강미	디지털타임스
이하늬, 비키니 수영복으로 뽐낸 건강미 [화보]	엑스포츠뉴스
[포토] 윤다연, 세계 대회 출신 다운 건강미	디지털타임스
이하늬, 비키니 수영복으로 뽐낸 건강미 [화보]	엑스포츠뉴스
설현 지난해 이어 청바지 브랜드 모델 재발탁 ‘압도적인 건강미’	스포츠경향
숀리 해명 "통통 발언, 볼륨감·건강미 때문"	경기일보
[SW포토] 송지효, 섹시미+건강미 넘치네	스포츠월드
"꾸준히 운동"…우도환, 촬영장서 건강미 발산	뉴스컬처
[스포츠경향 포토]‘머슬마니아’ 정지연, 탁구도 건강미도 놓치지 않아	스포츠경향
[스포츠경향 포토]공민서, 빛나는 건강미	스포츠경향
[스포츠경향 포토]머슬마니아 선발전, 건강미 알리는 핸드볼 여신	스포츠경향
[스포츠경향 포토]‘머슬마니아’ 박은주, 바이올리니스트의 건강미	스포츠경향
[스포츠경향 포토]‘머슬마니아’ 박은주, 바이올리니스트의 건강미	스포츠경향
[스포츠경향 포토]‘머슬마니아’ 최규진, 탄탄한 건강미	스포츠경향
[포토] CF촬영장서 건강미 폭발한 EXID 하니	뉴데일리
[MD포토] 씨스타, '건강미 넘치는 매력녀들'	마이데일리
공효진, 교통사고 前 건강미 넘치는 화보 공개	뉴스웨이
브레이브걸스 ‘변했어’, 머슬퀸다운 건강미 넘치는 무대	MBN
[포토] 보라, '건강미의 표본~'	한국경제
걸그룹 AOA, 신곡 ‘심쿵해’티저 공개…건강미 넘치는 라크로스 선수로 변신	국민일보
[bnt포토] 윤은혜, 그녀의 건강미 돋보이는 각선미(2014MAMA)	bnt뉴스
'60돌' 소녀주의보 지성 '건강미 넘치는 자태[엑's HD포토]	엑스포츠뉴스
걸그룹 AOA, 신곡 ‘심쿵해’티저 공개…건강미 넘치는 라크로스 선수로 변신	국민일보
[bnt포토] 윤은혜, 그녀의 건강미 돋보이는 각선미(2014MAMA)	bnt뉴스
'60돌' 소녀주의보 지성 '건강미 넘치는 자태[엑's HD포토]	엑스포츠뉴스
[T포토] 마마무 화사 '건강미 넘치는 각선미'	TV리포트
EXID 솔지, 건강미 넘치는 손인사 [MK포토]	MK스포츠
2014 아디다스 마이런 '건강미 넘치는 스트레칭 코치'[포토]	엑스포츠뉴스
[포토엔]소녀시대 효연 ‘건강미 돋보이게 하는 초밀착 원피스’(가요대전)	뉴스엔
[포토]'WFF SPORTS MODEL' 건강미가 우선이죠!	아시아경제
고흥군, ‘수호천사 건강미’ 5년 연속 전남 대표 브랜드쌀 선정	뉴스웨이
[사진]퍼펄즈,'건강미 넘치는 각선미'	OSEN
[포토] 소녀시대 유리 '건강미 넘치는 피부'	한국경제
[MD포토] 오윤아, '건강미 넘치는 입장'	마이데일리
‘마스터’ 엄지원 “건강미 위해 17번 태닝, 결과는 별로”	매일경제
베리굿 서율, 시선을 사로잡는 건강미	스타뉴스
[건강미박람회] LED 마스크 설명하는 셀리턴	매경헬스
[포토] 신수지 '건강미 만점 스포테이너~'	스포츠조선
[국제포토] 핫플레이스 “건강미 듬뿍” (엠카운트다운)	국제신문
[SK포토]‘더 바디쇼’ 건강미로 입장하는 레이디제인	스포츠경향
[E포토]황정음, 건강미 넘치는 밝은 미소	SBS funE
선미, 한층 물오른 미모.."증량 후 건강미 뿜뿜"	헤럴드POP
‘출발 드림팀’ 심으뜸, SNS에 ‘애플힙+건강미’ 넘치는 화보 ‘공개’	MBN
이본, 섹시한 날개뼈 처음이지? 건강미 폭발	스포츠동아
"수상스키 배우는 중"…소유, 건강미 자랑	TV리포트
[동아포토]AOA 유나 ‘건강미 넘치는 엔젤~’	스포츠동아
선미 체중, “원걸 때 38kg, 건강미 위해 체중 늘렸다”	이데일리
[bnt화보] 개미허리로 돌아온 티아라 함은정, 건강미 넘치는 바디라인	bnt뉴스
씨스타 보라, 건강미 넘치는 화보…고난이도 요가자세도 ‘척척’	매일경제
'사격장 뒤태녀' 예정화, 건강미 넘치는 골프복 화보 '눈길'	머니투데이
[엑's HD] KGC 치어리더 '건강미 뽐내며'	엑스포츠뉴스
에이핑크 박초롱X윤보미, 레깅스 패션으로 뽐낸 건강미 [화보]	엑스포츠뉴스
"치명적 글래머"..제시, 넘버원 건강미	헤럴드POP
[포토] 정유민 '밀착의상에 드러나는 건강미'	스포츠조선
[bnt포토] 씨스타 효린, 건강미 넘치는 웃음	bnt뉴스
유인나, '태양의 식후비법 W차' 모델 발탁…건강미의 아이콘	미디어펜
윤진서, 제주도 리얼 라이프 화보 통해 ‘건강미’ 발산	아주경제
강소라, 청순미부터 건강미까지…비하인드 컷도 여신이네	스포츠동아
씨스타 소유, 넘치는 건강미	스포츠한국
[사진]장희령,'러닝화 패션으로 각선미와 건강미 뽐내'	OSEN
[포토] 유예빈, 화려한 비키니로 건강미 뽐내	이데일리
씨스타 소유, 시원한 의상으로 건강미 발산..`런닝맨` 멤버들 들썩	이데일리
[현장포토] “이래서 갓수지”…수지, 군살제로 건강미	디스패치
송가연 롤모델, 론다 로우지… 건강미 넘치는 비키니 화보	동아일보
[스경포토] [머슬마니아] 장소영, UFC 챔피언 급 건강미	스포츠경향
설현, 건강미 넘치는 환한 미소 '정글 여신'	엑스포츠뉴스
'주먹이 운다' 송가연, '탄탄한 복근' 건강미 '발산'	전자신문
[포토]옥택연 화보서 `남성미+건강미` 물씬	이데일리
[포토] 치어리더 김소연, 건강미 물씬	스포츠서울
오하영 `건강미 넘쳐` [MK포토]	MK스포츠
[bnt포토] AOA 설현 '건강미 돋보이는 건치 미소'	bnt뉴스
에이핑크 보미X초롱, 스포츠웨어 모델 발탁···건강미 과시	텐아시아
심으뜸 '건강미 넘치는 래시가드 자태'[포토]	엑스포츠뉴스
[스포츠경향 포토]이소희, 건강미 담긴 뒤태	스포츠경향
[경인포토]'열한시' 제작보고회 김옥빈, 건강미 넘치는 탄탄한 각선미	경인일보
홍진영, 구릿빛 피부로 건강미 과시…“바비인형 미모”	스포츠동아
[스포츠경향 포토]‘발칙하게 고고’ 이미도, 건강미 넘치는 입장	스포츠경향
[NW포토]정윤혜, 건강미 넘치는 명품몸매 ‘레인보우 프리즘’	뉴스웨이
[사진]유승옥,'옥타곤걸의 건강미 뽐내며'	OSEN
‘섹시 여전사’ 제시, 건강미 넘치는 일상 ‘시선 올킬’	뉴스컬처
[스포츠경향 포토]신다원, 우아한 건강미	스포츠경향
[포토] `오른발부터`.. 건강미 넘치는 노팅힐 카니발	이데일리
씨스타, 건강미 돋보이는 ‘터치 마이 바디’ B컷 공개	파이낸셜뉴스
[머슬마니아 화보] ‘청순 건강미’ 이수지의 농염한 포즈	스포츠경향
한영, 건강미 넘치는 수영복 자태 공개…찍기만 해도 화보	영남일보
현아, 명품 비키니 자태…우월한 건강미	헤럴드경제
[스포츠경향 포토]‘머슬마니아’ 이연화, 그랑프리 수상자의 건강미	스포츠경향
[스포츠경향 포토]‘머슬마니아’ 강연지, 시선 사로잡는 건강미	스포츠경향
[포토] 브레이브걸스 민영, 건강미로 완성한 '섹시함'	부산일보
선미, 컴백 위해 체중 증가, 건강미+여성미 ↑	머니투데이
신세경, 건강미 물씬 복근 공개?	한국경제TV
[경인포토]디스커버리 신수지, 건강미 돋보이는 바디라인 '헉'	경인일보
[SW포토] 연미주, 건강미 물씬 퍼펙트 바디라인	스포츠월드
'아름다운 나의 신부' 이시영, 땡볕 촬영에도 건강미 넘치는 눈웃음	뉴데일리
홍지민, 변함없는 건강미 "나이는 숫자가 아니라 생각"	뉴스컬처
안신애, `건강미 넘치는 워킹` [MK포토]	MK스포츠
[포토S] 배우 최은주, 건강미 넘치는 몸매	스포티비뉴스
[스포츠경향 포토]‘2015 머슬마니아’ 건강미의 여신을 찾아라	스포츠경향
스테파니 리, 정말 긴 다리..'건강미'	스타뉴스
'하의실종' 백진희, 건강미 뿜뿜 화보에 강렬한 시선	한스경제
소녀시대 유리, '매혹적 건강미' 이탈리아 화보 공개	서울경제
걸스데이 혜리에게 이런 매력이… 건강미 넘어 섹시	스포츠동아
소녀시대 유리, '매혹적 건강미' 이탈리아 화보 공개	서울경제
걸스데이 혜리에게 이런 매력이… 건강미 넘어 섹시	스포츠동아
[포토] 한은정, '건강미 넘치는 각선미~'	한국경제
선미 체중, “원걸 때 38kg 보다 5kg 늘려…여성미 건강미 위해”	스포츠조선
[★화보]수빈, '밸롭' 모델 발탁…건강미 넘치는 래쉬가드 화보 공개	베타뉴스
[포토] 이주우 '복근 드러내며 건강미 자랑'	스포츠조선
[포토] 서은수, 건강미 넘치는 미모!	스포츠조선
이연화, '건강미 넘치는 자태'	글로벌경제
‘인천AG’ 성화봉송 주자 클라라 동준-홍보대사 이시영 ‘건강미’	OSEN
[포토] 건강미 넘치는 몸매와 화려한 날개의 조화 `브라질 카니발`	이데일리
치어리더 `건강미 넘치게 흔들흔들` [MK포토]	MK스포츠
[포토] '딴따라' 혜리, 건강미 넘치는 쇄골라인!	스포츠조선
마마무 화사, 건강미 넘치는 구릿빛 피부	스포츠한국
곽정화, `건강미 비결은 스트레칭(?)` [MBN포토]	MBN
‘주먹이 운다’ 송가연 vs 채보미, 건강미 진검 승부 ‘후끈’	스포츠동아
'비키니여왕' 이현민, 탄탄한 바디로 건강미 발산	부산일보
[동아포토]건강미 끝판왕 옥타곤3미녀	스포츠동아
"건강미 뿜뿜" 김준희, 탄탄한 몸매로 시선강탈	헤럴드POP
[★포토]이시영 '건강미 넘치는 각선미'	스타뉴스
이제훈X라붐 솔빈, 건강미 넘치는 아웃도어룩 화보[포토엔]	뉴스엔
아이오아이, 건강미에 청순미까지 명불허전 대세돌 [화보]	헤럴드POP
[사진]최여진,'건강미 넘치는 아찔 뒤태'	OSEN
[SS포토] '임팩트 9' 강리아, 건강미 넘치는 매력!	스포츠서울
소나무, 탄탄한 건강미 넘치는 ‘빙그르르’ 안무영상 기습 공개	한국경제TV
치어리더 `건강미 넘치는 각선미` [MK포토]	MK스포츠
NS윤지 뮤비 공개, 건강미+섹시미 어우러진 '환상 비주얼'	JTBC
[포토] 엄지원, 건강미 넘치는 각선미!	스포츠조선
"되찾은 건강미"…이태임, 관능적 수영복 자태 [화보]	스포츠조선
[포토]가희, 건강미 넘치는 '구릿빛 각선미'	헤럴드POP
안신애 `건강미 넘치는 뒤태` [MK포토]	MK스포츠
[포토]가희, 건강미 넘치는 '구릿빛 각선미'	헤럴드POP
안신애 `건강미 넘치는 뒤태` [MK포토]	MK스포츠
이하늬, 올해 최초 수영복 화보 '독보적인 건강미'	enews24
씨스타 '아이 스웨어' 뮤직비디오 공개…석양 속 멤버들의 건강미 눈길	텐아시아
신민아, 여성스러운 건강미 남성지 '아레나'표지 폭풍 발산 '매혹적인 눈빛'	부산일보
[포토]씨스타-서인국 화보 촬영, ‘건강미 과시’	이데일리
홍진영, 늘씬+탄탄 건강미 뽐내 "이렇게 예쁘다니"	더리더
[스포츠경향 포토]홍주연, 건강미에 자신감을 담았어	스포츠경향
차오루 "11자 복근 만드는 중"…건강미 넘치는 근황	미디어펜
[포토엔]손예진 ‘건강미 넘치는 각선미 드러내고’	뉴스엔
[포토엔]손예진 ‘건강미 넘치는 각선미 드러내고’	뉴스엔
[포토] 유라 '건강미 넘치는 미모'	스포츠조선
[포토]`오빠 나 몰라?` 맹승지, 로드걸 변신..건강미 뽐내	이데일리
가희, 시선 집중 명품 복근…"건강미 물씬"	TV리포트
[★포토]문가비, 넘치는 건강미	스타뉴스
[포토] 엄현경, 건강미 넘치는 입장	매일경제
이상화, 체중 공개에 섹시화보 재조명	동아일보
선미 솔로 캠백, 건강미 위해 체중 늘렸다더니‥	헬스조선
'식객남녀3' 먹방여신 정가은, '반전 드레스'로 섹시 건강미 발산	헤럴드경제
조여정, 무보정 직찍에도 굴욕없이 빛나는 미모 '건강미까지 더해'	한국경제TV
설현, 올림머리 하고 쉬크한 표정..'건강미 넘쳐'	스타뉴스
건강미 넘치는 손담비, 스포티룩도 완벽 소화[비하인드컷]	뉴스엔
나혼자산다 소유, 수상스키 실력 과시 '건강미 발산'	뉴스1
[SBS연기대상] 클라라, 건강미 넘치는 미소	뉴데일리
[포토] 마이크로닷, '건강미 넘치는 남자'	한국경제
손연재, 오션월드 광고모델 발탁…"군살없는 볼륨 건강미 과시"	뉴스핌
[스포츠경향 포토]‘피트니스스타’ 여성 그랑프리 진출 선수들의 건강미	스포츠경향
박보람 32kg 감량, 헬스장서 근력운동…‘건강미 물씬’	동아일보
건강미 발산하는 정아름-지나	연합뉴스
[포토엔]김보라, 건강미 넘치는 각선미	뉴스엔
민유라, 시선 강탈하는 구릿빛 피부에 건강미 넘치는 몸맵시	일간리더스경제
[포토]비키니 플래시몹, `건강미 넘치는 포즈`	이데일리
[브라질-칠레]건강미 넘치는 삼바의 여인	OSEN
최정원, 건강미 넘치는 구릿빛 피부	스포츠한국
[포토] 지나 '건강미 돋보이는 보디라인'	한국경제
[포토]2016 아시아뉴스타모델선발대회 미얀마, 건강미를 중시해요~	한국경제TV
가희, 절정의 건강미…"시선 집중"	TV리포트
<포토>한현민, 더위 날리는 탄탄한 건강미	데일리안
"센 언니의 시크"..제시, 글래머 건강미	헤럴드POP
루나, 건강미 넘치는 일상샷 공개 "셀프메이크업"	경인일보
론다 로우지, 前 남친 사진 유출돼 세미 누드 공개…탄탄한 상반신+건강미 ‘...	MBN
유리 화보, "탄탄한 보디라인으로 건강미 과시"	조세일보
티아라 은정 `건강미 넘치는 각선미` [MBN포토]	MBN
[T포토] 유라 '건강미 넘치는 S라인'	TV리포트
[포토] 워킹걸, 건강미 넘치는 조여정의 미소	뉴데일리
[포토] 라미란 '건강미 돋보이는 워킹'	파이낸셜뉴스
‘해피 투게더3’ 클라라, 레깅스 시구 “건강미 있는 모습 보여주고 싶었다”	서울경제
아이들 우기, 건강미 넘치는 테니스룩 (화보)	뉴스컬처
[HS포토] 이하늬, 건강미 넘치는 발걸음	한스경제
[사진]오윤아, '건강미 넘치는 각선미'	OSEN
[사진]오윤아, '건강미 넘치는 각선미'	OSEN
건강미 뽐내는 비키니 콘테스트 참가자	뉴스1
씨스타, 스케쳐스 모델 발탁.. '건강미 1등 걸그룹'	텐아시아
'미스마' 윤송아, 반적 매력 담긴 화보 공개 '건강미 물씬'	스포츠서울
[포토] 건강미 넘치는 비키니 모델, 허리 살짝 꺾으며 `S라인` 드러내	이데일리
[포토] 유리, 건강미 넘치는 웃음!	스포츠조선
최두호, 건강미 넘치는 아내와 함께 행복한 일상… '다정한 슈퍼보이'	경인일보
[포토] 씨스타 효린, '걸그룹 최고의 건강미!'	아주경제
[NW포토]박송이, 섹시미와 건강미 넘치는 구리빛 피부	뉴스웨이
이주연, 건강미 가득 언더웨어 화보 비하인드 컷	미디어펜
이주연, 건강미 가득 언더웨어 화보 비하인드 컷	미디어펜
건강미 넘치는 씨스타 효린	연합뉴스
[포토] 니카코리아 표지영, 건강미 넘치는 뒤태	RPM9
이효리 근황, 침대에 누워 건강미 과시 '구릿빛 피부~'	전자신문
손담비, 건강미 넘치는 명품몸매 공개 '감탄사 절로나오네~'	enews24
[화보] 이하늬, 탄탄한 바디라인 빛난 수영복 화보..‘건강미’	OSEN
[화보] `인라인스타` 궉채이, 터질 듯한 건강미	매일경제
[E포토]청하, '건강미 넘치는 각선미'	SBS funE
김용준, 건강미 넘치는 근황 모습 화제...‘몸짱’ 변신 대성공	전자신문
효린 `건강미 넘치는 핫바디` [MBN포토]	MBN
UFC 193 론다 로우지…매끈한 건강미 올누드 공개 ‘이럴수가‘	헤럴드경제
[포토]예지원, 해변에서 뽐낸 건강미	이데일리
선미 체중, 컴백 앞두고 건강미 살리기 위해 늘렸다 '눈길'	서울경제
[포토] 강소라, '건강미의 대표주자'	한국경제
[SK포토][멜론 뮤직 어워드] 씨스타, 완벽한 건강미 발산	스포츠경향
[e포토] 강시원, 넘치는 건강미	enews24
[포토] 유인영, '건강미 넘치는 각선미'	세계일보
한지혜, 구릿빛 피부로 건강미 발산	e대한경제
양정원, ‘맥심’ 화보서 몽환적 매력 발산 “건강미+로맨틱 섹시미”	서울신문
선미 체중 증가, “건강미 위해 38kg에서 43kg으로…”	강원일보
가희, 완벽한 수영복 뒤태 공개.. 건강미+섹시미 물씬	스타뉴스
‘연애 말고 결혼’ 한그루, 베이글 매력 절정 ‘건강미 빅매치’	스포츠동아
유인나, 별거 안 입어도 빛나는 진짜 명품 보디[포토엔]	뉴스엔
문지영, 피트니스 건강미 끝판왕	뉴시스
[포토]낸시 '건강미 넘치는 각선미'	헤럴드POP
가수 제시, 건강미 넘치는 일상샷 ‘눈길’	뉴스컬처
[스포츠경향 포토]밤비노 하담, 느껴지는 건강미	스포츠경향
[건강미박람회] 우지인의 ‘필록싱’ 강좌	매경헬스
남궁민 홍진영 우결 합류, 보기만 해도 건강미 느껴져… “대박이다!”	동아일보
[포토] 수현, 건강미 넘치는 미소	뉴데일리
[건강미박람회] ‘저칼로리 음식’ 비법 공개	매경헬스
[건강미박람회] 건강요리대회 대상은 우리 것!	매경헬스
옥택연 페이, 채리어트 여름 화보 통해 '건강미 커플' 입증	스포츠서울
박기량, 건강미 넘치는 화보 "치어리더들도 정규직 됐으면"	enews24
치어리더 `건강미 넘쳐 흐르네` [MK포토]	MK스포츠
[포토] AOA, '심쿵해' MV 비하인드컷 '건강미 발산'	이데일리
‘미모 한의사’ 왕혜문, 건강미 넘치는 매력… “합성 의심할 정도”	스포츠동아
[화보] ‘GTA 삼일절’ 송가연… 건강미 넘치는 바디라인 ‘눈길’	동아일보
[포토엔]AOA 설현 ‘건강미 넘치는 탄력각선미~’	뉴스엔
[건강미박람회] 좌식생활 줄이면 건강해진다	매경헬스
'브레이브걸스' 쇼케이스, 건강미 뽐내는 민영	뉴시스
씨엘, 누가 요요 소리를 냈을까? 건강미 넘치는 근황	헤럴드POP
윤소이, 화보 통해 건강미 발산…매끈한 각선미 '눈길'	머니투데이
[포토] 세정, 복근 드러내는 건강미~!	스포츠서울
[건강미박람회] 음파진동기로 지방 태워볼까	매경헬스
스테파니, 건강미 넘치는 매력 '자체발광 투명 미모' [화보]	엑스포츠뉴스
이하늬, 건강미 넘치는 래쉬가드 몸매…시선싹쓸이 [화보]	스포츠동아
'마이리틀텔레비전' 초아, 건강미 넘치는 매력 통했다	스포츠월드
[오마이포토] '에이핑크' 정은지, 팔근육 뽐내는 건강미	오마이뉴스
[사진]한은정, '건강미 넘치는 시구'	OSEN
[스포츠경향 포토]신다원, 파격 포즈-파격 건강미	스포츠경향
fx 루나, 건강미 넘치는 미모	스포츠한국
[포토] 머슬퀸 안소정, 카리스마 가득한 건강미	디지털타임스
[포토] 김가희, 핫팬츠와 비키니로 건강미 완성	디지털타임스
NS윤지, 식물성 음료 광고…건강미 넘치는 탄력적인 S라인	스포츠경향
[스포츠경향 포토]‘맥스큐 머슬마니아’ 안인선, 빼어난 건강미	스포츠경향
WBFF, 건강미 뽐내는 참가자들	연합뉴스
‘마리텔’ 우주소녀 성소, 서핑슈트 화제…건강미야? 섹시미야?	헤럴드경제
'자세도 건강미도 완벽'	뉴스1
'당신의 부탁' 임수정, 건강미 넘치는 식단 공개…"건강한 식사 하세요"	조세일보
시크릿 정하나, 건강미 넘치는 근황 전해.."내가 봐도 내가 아냐"	이데일리
씨스타 효린-소유, 스포츠 의류 화보서 탄탄한 건강미 발산	스포츠경향
'연극이 끝나고 난 뒤' 윤소희, '아이언 레이디' 촬영 포착 '건강미 발산'	OBS
김희정, 감탄 절로 나오는 건강미 ‘스포츠웨어 모델 발탁’	세계일보
배우 천이슬 건강미 넘치는 화보 "내 몸을 사랑하게 됐어요"	부산일보
건강·아름다움 비법은…MBN 건강미박람회 오늘 개막	MBN
'몬스터' 수현, 역대급 '비밀요원' 탄생…미모부터 건강미까지 '완벽'	한국경제TV
주지훈, 건강미 돋보이는 구릿빛 피부	서울경제
건강·아름다움 비법은…MBN 건강미박람회 내일 개막	MBN
'미녀 프로골퍼' 유현주 프로, 건강미 가득한 구릿빛 피부 '시선집중'	시민의소리
[포토] 걸스데이 민아 '건강미 물씬 넘치는 꿀벅지'	스포츠조선
이시영, 손인사까지도 건강미 넘치는 그녀 [MK포토]	MK스포츠
[포토] 모델 김라영, 전기차 앞에서 건강미 넘치는 실루엣 뽐내	에이빙뉴스
[NW포토]씨스타 보라, 건강미 넘치는 입장	뉴스웨이
레이디스 코드 애슐리, 첫 솔로 콘셉트 포토 공개…건강미 과시	웹데일리
'건강미가 넘쳐흘러~' 머슬 여신 3인방의 화려한 자태 [SS영상]	스포츠서울
[포토] 미스 말레이시아, 비키니와 어울리는 미소.. 건강미 뽐내	이데일리
루나 설리, 청순미냐 건강미냐 ‘선택하려면 머리 아플 듯’	스포츠동아
[포토] 씨스타 소유 '건강미 넘치는 라인'	파이낸셜뉴스
'건강미를 뽐내요'	뉴스1
뮬라웨어 쓰리패스, 반짝반짝 빛나...건강미 고스란히 드러내는 자태	글로벌경제
건강미의 워너비 김희정의 몸매 비결, 다이어트 성공신화 루나까지 극찬한 방...	주간한국
식음료업계, 건강미에 신뢰감까지 겸비한 30대 여배우 모델로 앞세우는 추세	로이슈
[사진]EXID 하니,'건강미 넘치는 각선미'	OSEN
[스포츠경향 포토]‘머슬마니아’ 낸시랭, 건강미 그 자체	스포츠경향
레이싱모델 김라영, 건강미 넘치는 각선미 라인 ‘눈길’	뉴스컬처
[스포츠경향 포토]‘머슬마니아’ 청순미와 건강미가 공존하는 미모	스포츠경향
청순미보다 건강미 "머슬녀 뜬다"	프라임경제
[포토] 치어리더, 건강미 넘치는 몸매	스포츠조선
‘머슬퀸 프로젝트’ 달샤벳 수빈, 건강미 넘치는 11자 복근...“드디어 촬영...	한국경제
청순미보다 건강미 "머슬녀 뜬다"	프라임경제
[포토] 치어리더, 건강미 넘치는 몸매	스포츠조선
‘머슬퀸 프로젝트’ 달샤벳 수빈, 건강미 넘치는 11자 복근...“드디어 촬영...	한국경제
눈길 사로잡는 건강미 발산한 이하늬, 보기만 해도 시원해지는 워터 피트니스...	브릿지경제
'코요태' 또 건강미 넘치는 신지는 더 ...	경남데일리
지효 `건강미 가득 구릿빛 피부` [MK포토]	MK스포츠
유승준 붕어빵 아들 공개 '건강미까지 닮았네'	OBS
[SW포토] 그룹 굿데이, 건강미 넘치는 무대	스포츠월드
[포토]윤세아, 골프웨어 입고 건강미 발산	이데일리
천이슬, 건강미 넘치는 보디라인 공개	조이뉴스24
[★SHOT!] 김유정, 되찾은 미소..건강미 뿜뿜	OSEN
10주년 건강미박람회 성황리 종료	매경헬스
화장대2 한채영, 실물 미모에 이특-리지 감탄 “건강미 넘치는 바비인형”	서울신문
[스포츠경향 포토]씨스타, 어디서 봐도 ‘완벽 건강미’	스포츠경향
[포토] 신민아, 아웃도어 브랜드 모델 발탁…건강미 발산	MBN
[스포츠경향 포토]‘머슬마니아’ 김소화, 초등학교 운동 선생님의 건강미란	스포츠경향
치어리더 이나경, 건강미 자랑하며 [MK포토]	MK스포츠
가희 '건강미 넘치는 11자 복근'	스포츠한국
[스포츠경향 포토]‘머슬마니아’ 박은주, 바이올리니스트의 반전 건강미	스포츠경향
걸스데이 혜리 '건강미 철철'	스포츠한국
[스포츠경향 포토]‘머슬마니아’ 박은주, 바이올리니스트의 반전 건강미	스포츠경향
걸스데이 혜리 '건강미 철철'	스포츠한국
[스포츠경향 포토]‘머슬마니아’ 김송이, 환한 미소로 건강미	스포츠경향
[★포토]소유, '건강미 넘치는 각선미'	스타뉴스
[★포토]'건강미 철철~' 스타의 구릿빛 피부②현아	머니투데이
[포토] 치어리더 '건강미가 빵빵~'	스포츠조선
조보아, 건강미부터 청순미까지 다 된다…감탄 부르는 잘록 허리	마이데일리
"센스만점 패셔니스타"..문가비, 건강미와 섹시미 모두 잡았다	헤럴드POP
[포토]섹시하고 건강미 넘치는 현아	아시아투데이
건강미의 상징 유승옥	뉴시스
유승옥, 건강미의 상징	뉴시스
[bnt포토] 류현경 '건강미 넘치는 슬림 각선미'	bnt뉴스
오정연 아나운서 12㎏ 쪘을 때 모습보니… 건강미 풀풀	국제신문
[포토엔]조정민 ‘건강미 넘치는 완벽 8등신 비율’(뮤직뱅크 출근길패션)	뉴스엔
[포토] 삼성생명 치어리더, 건강미 넘치는 몸매	스포츠조선
티아라 출신 화영, 건강미 넘치는 일상 공개 "촬영 중간 운동 중"	텐아시아
[OBS포토] 김옥빈, 건강미 넘치는 씨스루 패션 '남심 흔들'	OBS
[포토] 정희진, 건강미 넘치는 배우 참가자	디지털타임스
[건강미박람회] 유유제약, 약국용 건기식 선보여	매경헬스
[T포토] 마마무 화사 '건강미 넘치는 구릿빛 피부'	TV리포트
[사진]씨스타 보라,'넘치는 섹시 건강미'	OSEN
[포토] AOA 유나, 건강미 넘치는 각선미!	스포츠조선
이시영, 건강미 넘치는 의상으로 '시선집중' (SF8 제작발표회)	스냅
[포토] 맥스큐 커버걸 최규진, 건강미 넘치는 애플힙	RPM9
‘인기가요’ 브레이브 걸스, ‘머슬퀸’ 변신…‘건강미 아이콘’	MBN
강예빈, 광고 촬영 중 뽐낸 무결점 건강미 "배고파" [★해시태그]	엑스포츠뉴스
에이핑크 손나은, 건강미 발산	이데일리
"여름의 해변, 그녀"…보라, 넘치는 건강미 [화보]	스포츠조선
[포토엔HD] 채수빈 ‘건강미 넘치는 각선미 드러내고 종방연 나들이’	뉴스엔
이엘, 건강미 넘치는 몸매 공개 ‘슬림+탄탄’	MBN
레이양, 운동으로 다져진 복근 '건강미의 정석'	엑스포츠뉴스
엑소 카이, ‘퍼스트룩’ 커버 2종 장식	광주매일신문
레이양, CF 촬영장 무보정 비하인드 컷 공개…건강미 물씬	한국경제TV
[포토] 전효성 '건강미 장착한 허벅지~'	스포츠조선
가인, S라인의 정석..건강미 넘치는 각선미 '아찔'	OSEN
[사진]보라-다솜-효린,'이곳까지 전해지는 건강미'	OSEN
[S포토] 조아연, '건강미 넘치는 각선미로~' (K-뷰티니스 챔피언십)	스타데일리뉴스
씨스타 소유, 다솜 컴백화보 공개 ‘건강미 넘치는 섹시함’	스포츠경향
기은세, 원피스 사이로 허리 노출..실루엣으로 드러난 건강미	헤럴드POP
정아름, 건강미 넘치는 바디라인 과시… ‘탄탄한 뒤태’ 눈길	동아일보
강승현, 건강미 넘치는 화보… 男心 올킬	스포츠동아
[뉴타포토]신인 걸그룹 디엘(D.el) 현지 '원더우먼 연상케 하는 건강미'	뉴스타운
건강미 넘치는 이태임	노컷뉴스
손예진 근황…정글서 광고 촬영, 청순미 대신 건강미↑	엑스포츠뉴스
[사진]배수현,'건강미 넘치는 시구'	OSEN
에이핑크 정은지, 운동으로 다져진 건강미	스포츠한국
카라, 건강미 앞세워 케이스위스 모델로 발탁	스포츠조선
[포토] 나나 '건강미 돋보이는 치아 미소'	스포츠조선
[포토] 문가비 '시선 사로잡는 건강미'	스포츠조선
이지혜, 임산부 건강미 뿜뿜..'인간적인 팔뚝'[★SHOT!]	OSEN
[건강미박람회] '맛도 잡고 건강도 잡고'…건강요리교실	매경헬스
제시, 건강미 넘치는 구릿빛 피부	뉴스1
'겟잇뷰티' 이하늬, MC 발탁 기념 골반댄스 '건강미 폭발'	enews24
[포토] 클라라, `하의실종` 스포티룩으로 건강미 발산	매일경제
[포토] 씨스타 '건강미로 시선 올킬'	한국경제
[HI★포토] 김민정, ‘넘치는 건강미’	한국일보
[스경포토] [머슬마니아] 장아영, 늘씬한 건강미	스포츠경향
[스경포토] [머슬마니아] 최은주, 동안 미모에 건강미	스포츠경향
FNC 새 걸 그룹 체리블렛, 홈 트레이너 변신…예쁜데 건강미까지	TV리포트
나르샤, 다이어트 성공…볼륨감 넘치는 건강미 공개	스포츠경향
나르샤, 다이어트 성공…볼륨감 넘치는 건강미 공개	스포츠경향
'건강미란 이런 것'…이시영, 운동으로 다져진 탄탄한 몸매	마이데일리
이효리, 건강미 넘치는 무보정 사진 '눈길'	마이데일리
[포토] 엔젤걸 서우희, '건강미 넘치는 명품 각선미'(엔젤스파이팅08)	뉴스프리존
코트요정 키릴렌코, `건강미 넘치는 자태` [mk포토]	MK스포츠
'이동국 딸' 재시X재아, 이런게 진정한 폭풍 성장!..."건강미 넘치는 근황"	스페셜경제
[뉴스핌 포토] 씨스타 효린, ‘섹시한 건강미 뽐내며!'	뉴스핌
건강미 넘치는 포즈	뉴스1
[몸짱스타그램] 원빈 조카 ‘꼭지’의 변신…김희정의 남다른 건강미	스포츠경향
[스포츠경향 포토]최미진, 건강미 뽐내러 온 KIA타이거즈의 여신	스포츠경향
[스포츠경향 포토]‘2015 머슬마니아’ 우열 가리기 힘든 건강미	스포츠경향
선미 체중 증가, "건강미와 체력 위한 것 … 원걸 땐 40kg 못 미쳐"	스포츠월드
양민화, 거울속 셀카 탄탄한 몸매로 건강미 과시	한국경제TV
[포토]요가 선생된 소녀시대 유리 '건강미 넘치네'	이데일리
[포토]'건강미' 앤씨아, 쉐이크 잇 '썸머 K-POP 페스티벌'	부산일보
[포토]미쓰에이 페이, 건강미 넘치는 '구리빛피부'	아시아경제
엄현경, 친근한 이미지에 가려진 건강미	MBN
아이언 레이디 윤소희, 걸크러쉬 파이터의 건강미 뿜뿜	TV리포트
경리, 탄탄한 11자 복근 과시…건강미 '뿜뿜'	스포츠서울
류화영, 건강미 넘치는 일상 화제	뉴스컬처
류화영, 건강미 넘치는 일상 화제	뉴스컬처
최여진, 건강미 넘치는 완벽 바디라인 [포토]	엑스포츠뉴스
[SK포토]‘로드FC’ 로드걸 박시현, 건강미의 정석	스포츠경향
[포토] 치어리더 최미진 '건강미 물씬'	스포츠서울
'9분만에 5골' 레반도프스키, 건강미 아내와 그랜드 캐년에서 즐거운 한 때	텐아시아
[포토] 씨스타 보라-효린, 눈부신 건강미	헤럴드경제
씨스타 '터치 마이 바디' 안무 영상, 건강미 뽐내며 '애플힙' 댄스 "물오른 섹...	중부일보
[사진]신다은,'건강미 넘치는 각선미'	OSEN
[사진]소녀시대 효연,'건강미 넘치는 각선미'	OSEN
[화보]윤진서, 군살 제로 탄탄 복근 과시 '건강미 철철'	뉴스1
씨스타 효린, 농염한 건강미 뽐낸 화보 공개	OSEN
‘띠과외’ 송가연, ‘뽀얀 민낯+깔끔 포니테일+하얀 유도복’! 건강미 물씬!	한국경제TV
[★SNS]박신혜, 헝가리서 전해온 근황 '건강미 넘치는 그녀'	enews24
[사진]최여진-유승옥,'섹시한 건강미 대결'	OSEN
안세현, '건강미 가득한 모습'	서울경제
AOA 설현, 건강미 물씬 구릿빛 피부	스포츠한국
[건강미박람회] 휴온스, 갱년기엔 유산균?...국내 최초 갱년기 여성을 위한 ‘...	매경헬스
[포토] 트와이스 모모 '건강미 넘치는 각선미'	세계일보
[사진]손나은,'건강미 넘치는 각선미'	OSEN
[포토] 손나은, 건강미 넘치는 워킹	매일경제
배그린 "42kg→51kg, 절친 박신혜가 내 인생 바꿨다"[화보]	헤럴드POP
트레이너 정아름, 비키니 셀카 공개…구릿빛 피부 건강미 '폭발'	조세일보
샤샤 고운, 건강미 넘치는 각선미 [MK포토]	MK스포츠
김효진, 건강미 넘치는 시크한 유럽 엄마로 변신···광고촬영 현장 공개	서울경제
‘정글의 법칙’ 유이, 다이빙 수트 탈의…건강미 과시	SBS funE
하와이의 바람, 풀, 대지, 공기와 하나 된 김아중, 건강미 물씬 [화보]	매일경제
'파워타임' 하이니, 수영장서 건강미 뽐내며 휴가 만끽	스포츠한국
이시영, 복싱 훈련 중 한 컷 '건강미 가득'	텐아시아
[TEN PHOTO]트와이스 정연 '건강미 넘치는 각선미'	텐아시아
권상우 손태영 부부 등산 데이트, “건강미 넘쳐…”	동아일보
신수지 `건강미 넘치는 몸매` [MBN포토]	MBN
레이양, 건강미 뽐낸 레깅스 자태 '무보정 애플힙'	엑스포츠뉴스
전혜빈, 건강미 넘치는 몸매로 시선강탈	데일리안
이선빈, 축구팬 홀린 건강미 ‘시축도 힘차게’[포토엔]	뉴스엔
한채아, 광고 촬영장 속 완벽 운동복핏 포착…‘독보적 건강미’	bnt뉴스
'나혼자 산다' 소유, 능숙한 수상스키 실력 '건강미'	스타뉴스
'소녀 VS 숙녀'...AOA 지민, 야윈 몸매 걱정 날리는 건강미[화보]	enews24
'뮤직뱅크' 소나무, 탄탄 건강미 넘치는 '빙그르르'	텐아시아
지나, 섹시+건강미 넘치는 래쉬가드 화보 비하인드 컷 공개	파이낸셜뉴스
씨스타 효린 `건강미 가득` [MBN포토]	MBN
[★포토]권유리, '건강미 넘치는 각선미'	스타뉴스
고흥군, '수호천사건강미' 6년 연속 전남 10대 브랜드쌀 선정	뉴스메이커
"역시 패셔니스타"…김효진, 건강미 넘치는 시크한 엄마 변신	헤럴드POP
[유통가 투데이] 이마트 “코로나로 캠핑 수요 크게 늘어, 매출 17%↑”(10월...	IT조선
[엑's HD포토] SF9 태양 '넘치는 건강미'	엑스포츠뉴스
[포토] 정유미, ‘아름다운 건강미’	파이낸셜뉴스
[사진]에일리, '건강미 넘치는 발걸음'	OSEN
[NW포토]AOA, 섹시미와 건강미를 무기로 컴백!	뉴스웨이
[T포토] 효민 '건강미 넘치는 미소'	TV리포트
[공식] 노홍철-마닷-문가비 등 ‘공복자들’ 확정…완주 가능할까	스포츠동아
‘맨투맨’ 박해진, 훈훈건강미 발산...‘같이 운동하고 싶은 남자’	서울경제
지나, 화보 비하인드컷 공개…건강미 넘치는 모습 '男心 흔들'	SBS funE
김재중 헐크 근육, 건강미와 야성미 불끈 '운동돌' 등극	경인일보
여름철, 건강미 넘치는 아웃도어 메이크업 연출법은?	로이슈
NS윤지, 밀착원피스 ‘대체불가 몸매’…건강미는 덤	스포츠조선
[동아포토]미쓰에이 페이 ‘건강미 넘치는 각선미’	스포츠동아
레이양 "즐거운 추석 보내세요" 여전한 건강미	스타뉴스
[사진]이예나, '건강미 뽐내며'	OSEN
[화보]전혜빈, 살아 있는 볼륨감+11자 복근 '섹시한 건강미'	뉴스1
[E포토]씨스타 다솜, 건강미 넘치는 허벅지 라인	SBS funE
건강미 과시하는 수빈-송아름	연합뉴스
[포토]박준형, 여전히 넘치는 건강미	매일경제
[MD포토] AOA 찬미, '완벽한 건강미'	마이데일리
[포토] 유라 '눈길 사로잡는 건강미'	스포츠조선
[포토] 모델 정미리, 피트니스 화보 '건강미'	이데일리
[2019 서울가요대상] 건강미 넘치는 솔라	매일경제
[포토] 현아, 건강미 피부톤	매일경제
‘연애의 기술’ 한수아, 건강미 넘치는 비키니 자태	스포츠동아
일본 치어리더 `건강미 넘치네` [MK포토]	MK스포츠
[포토] 송해나, '건강미 넘치는 그녀'(2019 MGMA)	한국경제
[포토] 송해나, '건강미 넘치는 그녀'(2019 MGMA)	한국경제
이하늬, 다채로운 콘셉트의 수영복 화보 공개...건강미로 ‘시선 강탈’	국제신문
[MD포토] 유아인 '건강미 넘치는 구릿빛 피부'	마이데일리
채은정, 건강미 넘치는 수영복 인증샷..몸매 돋보여	헤럴드POP
[★포토]길미, '건강미 넘치는 각선미'	스타뉴스
[포토] 씨스타 보라 '건강미 넘치는 구리빛 미모'	한국경제
[포토] 씨스타 효린 '건강미 돋보이는 구리빛 각선미'	한국경제
청순미보다 건강미, ‘머슬녀’ 뜬다	아시아경제
안혜경, 100% 무보정! 필라테스로 다져진 건강미 넘치는 탄탄한 뒤태 과시!	서울경제
구하라, 건강미 넘치는 여름 화보 공개 '시선집중'	충청일보
구하라 화보 속 개미허리 과시…건강미 넘치는 매력女	TV리포트
[사진]정유주,'돋보이는 건강미'(2019 머슬마니아)	OSEN
[포토] 단하나, 아픔 이겨내고 건강미 넘치는 트레이너로 거듭나	이데일리
채연, '건강미 넘치는 섹시美' (쇼케이스)	서울경제
씨스타 효린 화보 공개..섹시+건강미 매력 여전	스타뉴스
"신비로움과 러블리 사이"...이솜, 자연스러운 건강미 공개	스포츠서울
스타트레이너 레이양, 한가위 맞아 건강미 넘치는 추석 인사	뉴스엔
[사진]김효진,'건강미 넘치는 자태'(2019 머슬마니아)	OSEN
[사진]김지안,'돋보이는 건강미'(2019 머슬마니아)	OSEN
[사진]정수민,'변치않는 건강미'(2019 머슬마니아)	OSEN
AOA 설현, 청바지 모델 재계약…건강미 '물씬'	데일리안
정영주, 최근 근황보니? 건강미 넘치는 섹시미 '인어같아'	위키리크스한국
‘핫바디’ 유승옥, 더 이상 “섹시는 없다”…건강미+섹시미 화보	뉴스웨이
'야노시호' 요가복을 입고 건강미를 자랑하고 있는 모습이다	일간리더스경제
옵스킨(OPSKIN) '틴 콜라겐', 2020 MBN 브랜드 대상 수상	열린뉴스통신
클라라 의상 해명 "탄탄한 몸매와 건강미에 맞춘 의상"	한국경제
이하늬 독보적 건강미 이룬 다이어트 비법은?	브릿지경제
[포토엔]장재인 ‘건강미 넘치는 각선미 드러내고~’	뉴스엔
[NW포토]신봉주, 건강미는 기본 섹시미 풍만한 구리빛 피부	뉴스웨이
강수진, 범접할 수 없는 강인함과 우아함 담긴 건강미 뽐내	마이데일리
[사진]전효성,'건강미 넘치는 각선미'	OSEN
고나은, 건강미 넘치는 일상 사진 공개 '눈길'	한국경제TV
소녀시대 윤아-유리 티저 공개, 여유롭거나 건강미 뽐내거나	MBN
"건강미 넘쳐" 황보, 수영복 입고 뽐낸 탄탄한 몸매 [★SNS]	스포츠서울
'탄탄한 건강미' 김준희, 완벽한 몸선 선보여..."예쁜 뒤태 갖고 싶다"	뉴스컬처
윤재인, `건강미 넘치는 각선미` [MK포토]	MK스포츠
최희서, 건강미 넘치는 각선미 [2018 청룡영화제]	MK스포츠
이시영 근황, 복싱으로 다져진 몸매로 건강미 과시	MBN
'8kg 증량' 선미, 50kg 몸무게 인증 '건강미 물씬 이유 있었네'[★SNS]	enews24
[포토] 이시영, '건강미 넘치는 그녀'	한국경제
'솔비가 후덕해졌다?' 솔비 근황, 서울패션위크 모습 보니…'건강미 넘쳐'	스포츠서울
[ET-SNS] 강소라, 광고 촬영 중 해변가서 건강미 넘치는 모습 "아직은 살짝 추...	전자신문
“5인의 헬스걸 납시오~” EXID 건강미 넘치는 화보	뉴스1
[카드뉴스] 건강미박람회 관람포인트 ‘전지적 참여 시점’	매경헬스
[포토] 엄현경, '건강미 넘치는 모습'	한국경제
헬로비너스 ‘위글위글’, 건강미 넘치는 몸매에 남심은 ‘흔들흔들’	한국경제
아이오아이 김세정·정채연, 화보 속에서도 빛나는 미모…‘건강미 물씬’	MBN
머슬 미녀 전성시대… 최여진·유승옥·예정화, 섹시 건강미 ‘핫핫핫’	뉴스웨이
'엄마가 뭐길래' 김서형, 건강미 넘치는 S라인 공개	스포츠월드
[mk포토] 남장 벗은 김연아, `건강미 넘치는 S라인`	매일경제
소녀주의보 지성, 건강미 넘치는 S라인의 교과서… "몸무게 60kg 아님"	경인일보
송경아, 야간 조깅 후 자랑한 건강미 넘치는 눈부신 각선미	뉴스컬처
[포토] 전혜빈 '건강미 뽐내는 치아 미소'	스포츠조선
베리굿 조현, 건강미 돋보이는 화려한 레깅스 패션 '시선압도'	스페셜경제
[포토] `미스 범범 브라질 2016` 건강미 넘치는 보디라인	이데일리
'9분만에 5골' 레반도프스키, 건강미 넘치는 아내와 헬스장 셀카 '훈훈 스포츠...	텐아시아
션, 건강미 넘치는 구릿빛 팔근육	스포츠한국
[★포토]오윤아, '건강미 넘치는 각선미'	스타뉴스
음악중심 씨스타, 건강미 넘치는 섹시한 무대…‘쉐이크 잇’	MBN
“세련되고 섹시”…고준희, 건강미 넘치는 몸매 [화보]	스포츠동아
이하늬, 팬사인회에서도 숨길 수 없는 ‘건강미’ 발산	마이데일리
‘미모 한의사’ 왕혜문, 근육질 몸매로 건강미 과시… “합성 아니야?”	스포츠동아
'주군의 태양' 공효진, 오리발 신고 건강미 넘치는 각선미 뽐내	bnt뉴스
[사진]에일리,'건강미 넘치는 각선미'	OSEN
[E포토]시크릿, 건강미 넘치는 그녀들의 파이팅!	SBS funE
[포토]이서진 '건강미 넘치는 외모'	헤럴드POP
‘10kg 감량’ 손승연 "새 앨범 기대해주세요" 볼륨감·건강미 넘쳐	매일경제
연우-낸시 `건강미 넘치는 댄스` [MK포토]	MK스포츠
[포토] 슈퍼핏 클래식 방승미, 건강미 넘치는 S라인	RPM9
'시크릿' 징거, 갈비뼈 부상 딛고 건강미 뽐내	이데일리
'시크릿' 징거, 갈비뼈 부상 딛고 건강미 뽐내	이데일리
투비스 박가현, 올 여름도 핫하게…건강미 과시(화보)	MBN
[포토] 유승옥, '건강미 넘치는 그녀'	한국경제
[★포토]김진솔 '건강미 넘치네'	스타뉴스
AOA 찬미, '머슬퀸 프로젝트' 멘티 참여…' 건강미 시너지 발산'	충청일보
[사진] 홍진영 '넘치는 건강미'	뉴스핌
"건강 위해 칼로리 체크"…소녀시대 서현, 맑은 건강미[화보]	헤럴드POP
이하늬, 독보적인 건강미	스타뉴스
'마스터' 엄지원 "건강미 위해 태닝만 17번..실패했다" 폭소	OSEN
[사진]달샤벳,'건강미 넘치는 각선미'	OSEN
사희 화보, 탄탄한 명품 바디라인 공개 '건강미 넘치는 매력'	경인일보
[스포츠경향 포토]신다원-최설화, 각기 다른 건강미	스포츠경향
차오루, 건강미 넘치는 반전몸매 공개 "헬스+리듬체조 다이어트 탁월"	마이데일리
[포토] 조여정, 미소마저 건강미 넘치는 여신	스포츠동아
[건강미박람회] 건강요리대회 심사 중인 김소봉 셰프	매경헬스
[★포토]건강미 넘치는 구릿빛 비키니 미녀!	스타뉴스
시크릿, 단체 티저 공개..늘씬+건강미 컴백 기대↑	스타뉴스
안다르, 마마무와 함께한 FW 신상품 ‘에어웜 기모 지니 레깅스’ 공개	위키트리
설현, 뷰티헬스케어 브랜드 모델 화보 공개	국방일보
[사진]씨스타-효린,'건강미 넘치는 각선미!'	OSEN
[T포토] 현아 '건강미 넘치는 뒤태'	TV리포트
‘미녀 트레이너’ 레이양, 화보 통해 섹시 등근육 과시...건강미 ‘폭발’	한국경제
예비엄마 이시영 근황 포착 ‘뒤태마저 건강미 물씬’	뉴스엔
레이양, 명품 비키니 자태…'건강미 물씬'	TV리포트
강소라, 감탄 자아내는 건강미 넘치는 자태 '보기만 해도 시원해'	울산매일신문
[경기포토] 유이, '탄탄+매끈' 꿀벅지 "건강미 넘쳐"	경기일보
[스포츠경향 포토]이소희, 확실한 건강미	스포츠경향
[★해시태그] "본격적인 다이어트"...김준희, 건강미 넘치는 일상	엑스포츠뉴스
[스포츠경향 포토]‘맥스큐 머슬마니아’ 이휘진, 화려한 의상 속 건강미	스포츠경향
"인기 헬스 트레이너가 내 눈앞에"…MBN 건강미 박람회 막 내려	MBN
유승옥 UFC 서울, '탄탄하고 건강미 넘치는 몸매에 눈길…' 한국의 힘을 보여...	조선비즈
fx 루나, 건강미 돋보이는 패션	스포츠한국
브레이브걸스 혜란 '건강미 넘치는 미모'	스포츠한국
브레이브걸스 '건강미 넘치는 라인'	스포츠한국
[포토] 조민수 '건강미 넘치는 미모'	한국경제
[건강미박람회] ‘건강 OX퀴즈’ 열정적인 참가자들	매경헬스
옥택연, 페이 건강미 넘치는 커플룩	한국경제TV
효린 B컷, 섹시한 건강미란 이런 것..네티즌 "역시"	OSEN
'서핑 마니아' 가희, 건강미 넘치는 탄탄한 몸매	이데일리
"보디슈트로 압도"…효민, 건강미 넘치는 완벽 몸매 [화보]	마이데일리
[NW포토]씨스타 효린, 미소에도 건강미 넘치네~	뉴스웨이
[포토] 김사랑, 건강미 넘치는 뒤태	경상일보
[포토] 최미진 '머리부터 발끝까지 건강미'	스포츠조선
[사진]미스 섹시백, 건강미 넘치는 포즈	OSEN
오인혜, 눈 둘곳 없는 과감 포즈 '탄탄 복근 건강미'	마이데일리
이보영, 다이어트 브랜드 CF 통해 건강미 과시	스포츠조선
[스포츠경향 포토]‘머슬마니아’ 낸시랭, 배구로 건강미 표현	스포츠경향
김정민, 매끈한 복근과 각선미 "건강미의 화신"	데일리안
전효성 거울 셀카, 올킬 글래머다운 매력 ‘건강미 충만’	스포츠동아
[스포츠경향 포토]‘머슬마니아’ 낸시랭, 늘씬한 자태로 건강미 과시	스포츠경향
[스포츠경향 포토]‘머슬마니아’ 낸시랭, 늘씬한 자태로 건강미 과시	스포츠경향
[스포츠경향 포토]‘머슬마니아’ 낸시랭, 우아한 손짓으로 건강미 표현	스포츠경향
[스포츠경향 포토]‘머슬마니아’ 치어리더 배수현, 완벽한 건강미	스포츠경향
에일리 10kg 감량 무보정 샷, 건강미 ‘철철’…한국의 비욘세 등극?	한국경제
‘나쁜 기집애’ 씨엘, 건강미 넘치는 보디라인	스포츠동아
[bnt포토] 레이양 '건강미 넘치는 미소'	bnt뉴스
[포토] 송지효 '건강미 넘치는 각선미'	한국경제
치어리더, `건강미 넘치는 볼륨감` [mk포토]	MK스포츠
[N샷] 설리, 탄탄 복근 공개…넘치는 건강미 발산	뉴스1
(2015머슬마니아) '최고의 건강미 미녀는 누구?'[포토]	엑스포츠뉴스
[포토] AOA '건강미 강조하며 컴백'	스포츠조선
[포토]강예원, 건강미 넘치는 매끈한 S라인	이데일리
스테파니 리, 언더웨어 화보서 건강미 뽐내..바짝 선 복근	이데일리
이엘, 피트니스 화보 공개…"건강미 넘치는 보디라인"	머니투데이
오정연 서핑장 나들이, 서울대 체교과 출신다운 건강미[SNS★컷]	뉴스엔
[사진]이영아,'건강미 넘치는 각선미'	OSEN
씨스타, 올 7월 파워풀한 건강미에 섹시함까지 더해 돌아온다	매일경제
선미 체중 중가, 5㎏에 건강미와 여성미 담았다	국제신문
조여정 건강미 포착, 당당한 아름다움 '눈길'	TV리포트
[동아포토]소녀주의보 지성, 빛나는 건강미	스포츠동아
'라푼젤' 맨디 무어, 건강미 넘치는 근황으로 시선 강탈	경인일보
'건강미의 정석' 양정원, 자동차 광고 촬영 인증샷	스포츠조선
[★포토]'건강미 철철~' 스타의 구릿빛 피부①조여정	머니투데이
[포토] 마마무 화사, '건강미 넘치는 모습에 눈길~' (서울가요대상)	한국경제
[포토] 김희정, '건강미 넘치는 그녀'	한국경제
[bnt포토] 공효진, 건강미 넘치는 각선미	bnt뉴스
'건강미 아이콘' 유승옥, 다이어트엑스포 참석 '눈길'	부산일보
하지원, 세사리빙 전속모델 발탁 "건강미 넘치는 매력"	TV리포트
[포토]'WFF WOMAN 2체급' 건강미와 여성미를 한 번에~	아시아경제
[포토] 이연, 완벽한 건강미	스포츠경향
[포토] 김희정, '건강미 넘치는 그녀'	한국경제
[bnt포토] 공효진, 건강미 넘치는 각선미	bnt뉴스
'건강미 아이콘' 유승옥, 다이어트엑스포 참석 '눈길'	부산일보
하지원, 세사리빙 전속모델 발탁 "건강미 넘치는 매력"	TV리포트
[포토]'WFF WOMAN 2체급' 건강미와 여성미를 한 번에~	아시아경제
[포토] 이연, 완벽한 건강미	스포츠경향
설현, 건강미 대신 신비로운 성숙한 여인으로 완벽 빙의	마이데일리
“여름그룹 씨스타, 섹시한 건강미로 컴백”	TV리포트
[스포츠경향 포토]씨스타. 공항서도 빛나는 건강미	스포츠경향
이하늬, 골프웨어 까스텔바쟉과 건강미 넘치는 스타일링	스포츠월드
[스포츠경향 포토]씨스타. 건강미 넘치는 여름 패션	스포츠경향
정진운 생존신고…'정글2' 촬영으로 탄 피부, 건강미 UP	뉴스1
‘정글의 법칙’서 건강미 뽐낸 김희정, 배상면주가 'R4' 광고모델 발탁	파이낸셜뉴스
[포토] 씨스타 '건강미 넘치는 바디라인'	파이낸셜뉴스
[스포츠경향 포토]‘머슬마니아’ 김송이, 건강미의 여걸로 변신	스포츠경향
[포토] 립버블 '건강미 발산하며 등장'	스포츠조선
미쓰에이 수지, 래쉬가드에 핫팬츠…건강미 '물씬'	머니투데이
"순금에 80만원짜리 블라우스까지"… 살 빼면 '통큰 경품' 준다	머니S
밥 두 그릇 먹고 온 송보은, 파워풀 줌바댄스 '건강미 폭발'(출발 드림팀)	스포츠조선
하니 “EXID만의 강점? 섹시+건강미”(V라이브)	MBN
‘엠카’ 씨스타, 신곡 ‘I swear' 공개 ‘씨스타표 건강미 발산’	텐아시아
[포토] 맥스큐 화보 이휘진, 예쁜 미소와 건강미 넘치는 애플힙	RPM9
‘42kg→51kg’ 배그린, 여자 김종국다운 수영복 화보[포토엔]	뉴스엔
[포토엔]민소매 건강미 넘치는 강지환, 영화 기대되요~	뉴스엔
"넘치는 건강미"…이하늬, 탄탄 복근에 완벽 몸매 라인 [화보]	마이데일리
'다이어트 도시락', 건강미 뽐낼 수 있어	리서치페이퍼
[사진]우주소녀 엑시,'건강미 뽐내며'	OSEN
[TEN PHOTO]트와이스 채영 '건강미 넘치는 피부'	텐아시아
[동아포토]씨스타 소유 ‘건강미 넘치는 악녀보디~’	스포츠동아
강소라, 시리얼 광고 모델 발탁 '건강미 물씬'	엑스포츠뉴스
[스포츠경향 포토]머슬마니아 이소희, ‘머슬 여신’의 건강미	스포츠경향
어나이 '건강미 넘치는 미소'[포토]	엑스포츠뉴스
김소니아, 비욘세 댄스 완벽소화 "건강미 넘쳐"	머니투데이
두산 파울라, `건강미 넘치네` [MK포토]	MK스포츠
[포토] 씨스타와 함께 `우유` 마시고 건강미 살리자	이데일리
홍진영 역대급 건강미 '이렇게 글래머였어?' 깜짝!	MBN
[E포토]모모랜드 제인, 건강미 넘치는 댄스	SBS funE
고은아 근육…“건강미 물씬”	강원일보
배우 ‘이엘’의 건강미를 보고 싶다면	국제신문
이혜영, 탄탄한 건강미 발산 '완벽 비키니 자태'	브릿지경제
송가연 롤모델, UFC 챔피언 론다 로우지… 건강미 넘치는 비키니 화보	동아일보
[포토] 마마무 화사, ‘구리빛 비주얼~넘치는 건강미’	파이낸셜뉴스
[MD포토] 지나 '건강미 넘치는 미소'	마이데일리
[포토] 전혜빈, '건강미의 표본~'	한국경제
[S포토] 이나라, '건강미 넘치는 여신미로~' (까웨 르브레 파티)	스타데일리뉴스
[T포토] 최여진 '건강미 넘치네'	TV리포트
나르샤, 건강미 넘치는 일상샷 ‘시선 집중’	뉴스컬처
한혜진, '전현무가 반한 건강미'	서울경제
류윈 스포츠 화보로 근황 전해 “건강미 넘치는 그녀”	인민망
효린 B컷 화보…건강미와 발랄함, 섹시함까지 다 잡았다	JTBC
에이핑크 정은지, 건강미 넘치는 매력 과시 "등등등"	시사매거진
롯데 치어리더 박기량의 건강미 넘치는 화보 '눈길'	아주경제
최여진, '더 바디쇼' 메인MC 발탁…건강미 넘치는 스틸컷 공개 '감탄'	중부일보
라붐 `건강미 넘치는 몸매` [MBN포토]	MBN
[MD포토] 프로미스나인 이채영, '건강미 가득한 공항패션'	마이데일리
[포토] 배우 최여진, 넘치는 건강미	뉴데일리
[포토] 카드 전소민, '섹시함에 건강미까지~'	스포츠조선
솔비 11자 복근, "예쁜 몸 만들면서 마음까지 잡아요" 건강미 과시	서울경제
KIA 치어리더, `건강미 넘치는 공연` [MK포토]	MK스포츠
[★SNS]손연재, 구릿빛 피부로 건강미 더한 '인형 미모'	스포츠서울
[e포토] 파나틱스 지아이, 건강미 넘치는 하트	enews24
'버디버디' 유이, 각선미 종결자 등극 '건강미 물씬' 바비인형	서울신문
[mk포토] 효린 애국가 제창, 건강미 넘치는 옆라인	매일경제
구세경, '아름다운 건강미'	뉴스1
[동아포토]김성령 '나이 잊은 건강미' (MBC연기대상)	스포츠동아
고흥군 ‘수호천사건강미’, 6년 연속 전남 10대 브랜드쌀 선정	신아일보
건강미 넘치는 유승옥	뉴스1
'하트시그널2' 오영주, 뜻밖의 건강미 화제...왜?	경기도민일보
레이양, 머슬 여신의 아름다움 '건강미 물씬'	엑스포츠뉴스
이특 등근육 공개, 건강미 넘치는 반전몸매 "아이돌이 아니라 모델이네~"	경인일보
이특 등근육 공개, 건강미 넘치는 반전몸매 "아이돌이 아니라 모델이네~"	경인일보
[T포토-Lab] 최여진 '건강미의 대명사, 미모도 몸매도 활력 가득'	TV리포트
[포토] 케이틀린 오스먼드 '건강미가 뿜뿜'	스포츠조선
[포토] 하지원, 건강미 넘치는 각선미	서울경제
박수진, 배용준과 결혼 앞둬… 요가로 얻은 건강미 주목	헬스조선
씨스타, `건강미 넘쳐~` [MBN포토]	MBN
선미 '건강미와 함께 찾아온 리즈 미모'[엑's HD화보]	엑스포츠뉴스
"톱모델의 건강미"…장윤주, 태국 더위도 사그라드는 카리스마 [화보]	마이데일리
김아중, 건강미 넘치는 래쉬가드화보 공개...숨겨둔 볼륨감 '눈길'	부산일보
[SW포토] 김아중, 건강미 넘치는 섹시함 ‘팔색조 매력’	스포츠월드
브레이브걸스, '변했어' 재킷·비하인드 포스터 공개 '역대급 건강미'	OBS
[포토] 헤이걸스 잔디 '건강미 발산하는 시구'	스포츠조선
조여정 건강미, 생기발랄 넘치는 미소~ '파격적인 반전 뒤태'	한국경제
오정연, 감탄 부른 '개미허리'에 단아함까지 [스타IN★]	스타뉴스
[경인포토]씨스타 쇼케이스, 건강미 넘치는 바디라인… '다이어트 자극'	경인일보
보라 `건강미 넘치는 스키니 각선미` [MBN포토]	MBN
[대한민국-벨기에] 베스티, `건강미 넘치는 구리빛 피부`	MBN
모모랜드 연우, 한쪽 눈 감고 윙크해... 가리키고 있는 것은 뭐? 건강미와 상...	경상일보
류현진 아내 배지현, 건강미+에너지 갖춘 완벽 미모	넥스트데일리
레이양 '건강미 넘치는 미소'[엑's HD포토]	엑스포츠뉴스
[스포츠경향 포토]신다원, 건강미 담긴 선명한 복근	스포츠경향
브레이브걸스, 머슬퀸 콘셉트로 건강미 과시 '애슬레저룩 화제'	enews24
[사진]예정화,'건강미 넘치는 바디라인'	OSEN
설인아, 급이 다른 건강미 [MK포토]	MK스포츠
[포토] 최여진, 건강미 넘치는 발걸음	한국경제TV
[사진]머슬마니아 낸시랭,'건강미 넘치는 구릿빛 피부'	OSEN
‘건강미 강조’ 클라라, 레깅스 시구 ‘욕심 탓’ 사과	데일리안
[포토] 치어리더 '건강미 발산하며~'	스포츠조선
한지우, 건강미 돋보이는 민낯 셀카 공개	뉴스타운
[스포츠경향 포토]이소희, 범접할 수 없는 건강미	스포츠경향
한지우, 건강미 돋보이는 민낯 셀카 공개	뉴스타운
[스포츠경향 포토]이소희, 범접할 수 없는 건강미	스포츠경향
[포토]손담비 '건강미 넘치는 각선미'	헤럴드POP
마마무 화사, 탄탄한 바디라인 자랑하는 자세로 건강미 과시	뉴스컬처
진서연, 생일 기념 완벽 물구나무 ‘건강미 철철’[SNS★컷]	뉴스엔
신은수, 스킨푸드 모델 발탁...투명한 피부로 전하는 건강미	부산일보
[스경포토] [머슬마니아] 홍다현, 우아한 건강미 담아	스포츠경향
[스경포토] [머슬마니아] 이윤선, 건강미 풍기는 나비	스포츠경향
엄정화, 건강미 넘치는 구릿빛 피부…'美친 동안 미모'	경남데일리
[스포츠경향 포토]‘2015 머슬마니아’ 송혜주, 완벽한 복근으로 건강미	스포츠경향
[스포츠경향 포토]‘2015 머슬마니아’ 누가누가 더 건강미를 담았나	스포츠경향
유승옥, 'UFC 서울' 옥타곤걸 발탁…"건강미 넘치는 몸매, 좋은 평가받아"	스포츠조선
모델 문가비, 흑진주 피부에 건강미 뿜뿜...화보 촬영사진 공개	CNB뉴스
[SS포토]에프엑스 루나 '건강미 넘치는 구릿빛 피부'	스포츠서울
정다래, '건강미 가득한 매력'	서울경제
[포토] 하지원 '민소매 의상에 건강미'	스포츠조선
[머슬마니아 화보] 35㎏ 감량하고 ‘건강미 포텐’ 터뜨린 이은경	스포츠경향
'런닝맨' 유승옥, 건강미 넘치는 몸매로 시선 집중	쿠키뉴스
[사진]김성은,'건강미 넘치는 미소로 손 인사'	OSEN
건강미 넘치는 뒤태 미녀	뉴스1
[사진]김성은,'건강미 넘치는 미소로 손 인사'	OSEN
건강미 넘치는 뒤태 미녀	뉴스1
에일리, 핫팬츠 패션에 돋보이는 건강미 넘치는 각선미 '눈길'	스페셜경제
최여진, '건강미 폭발' 성난 등근육 과시 "등신이 되자"	축산신문
[포토] 건강미 넘치는 `브라질 카니발`.. 몸매도 화려해	이데일리
BJ가을이, 오픈 숄더 의상으로 뽐낸 건강미 ‘군살 제로’	뉴스컬처
[포토] 레이디스 코드 애슐리, '건강미 써머퀸'	스포츠조선
[포토] 레이디스 코드 애슐리, '건강미 뒤태'	스포츠조선
"하루 3시간 운동 기본" 배그린, 42kg→51kg 수영복 화보 공개 '탄력 S라인'	중부일보
인라인스타 궉채이 ‘청순+건강미’ 화보 공개	동아일보
설리, 멕시코 칸쿤에서 선보인 비치 룩…건강미 '물씬'	머니투데이
엄현경, 괌에서 촬영한 건강미 넘치는 화보 공개	스포츠경향
솔비 근황, 건강미 넘치는 모습 공개 “누가 후덕해졌대?”	코리아헤럴드
[포토] 네이처 유채, '건강미 넘치는 그녀~'	한국경제
"땀도 흘리고 신나" 윤은혜, 건강미 넘치는 근황 공개	TV리포트
[e포토] 트와이스 채영, 넘치는 건강미	enews24
[포토] 이시영, 건강미 넘치는 청순 미모!	스포츠조선
이하늬, 건강미의 비결은 스마일과 채식	e대한경제
"걸크러쉬 건강미"…손담비, 눈길 가는 래쉬가드 자태	마이데일리
한혜진, 집에서도 다이어트 중…건강미 가득 인증샷 공개	톱스타뉴스
[포토] 이효리, '건강미 넘치는 S라인'	OBS
[사진]구잘, '건강미 넘치는 각선미'	OSEN
[bnt포토] 네이처 선샤인 '보는 사람도 쌍따봉하고 싶은 건강미'	bnt뉴스
[TEN PHOTO]마마무 화사 '건강미 강조한 구리빛 피부'	텐아시아
[포토] '오토살롱위크' 안나경, 건강미 넘치는 몸매를 뽐내며	RPM9
[포토] 에프엑스 루나 '건강미 넘치네'	파이낸셜뉴스
스테파니 라이스, 비키니 사진에 건강미 '눈길'	장애인신문
[T포토] 전효성 '미소부터 건강미 넘쳐'	TV리포트
[사진]레이디스코드,'건강미 넘치는 각선미'	OSEN
[NW포토]로봇 소리 이하늬, ‘건강미 넘치는 비주얼’	뉴스웨이
씨스타 다솜 VS 소유, ‘건강미 넘치는 극과극 각선미 대결’	세계일보
한채아, 운동기구 촬영 현장에서 보여준 절세의 건강미	스포츠경향
서정희 딸 서동주, 풍만 볼륨감에 시선강탈 ‘건강미 철철’[SNS★컷]	뉴스엔
[포토]네온펀치 테리, '건강미가 최고'	이데일리
‘마리텔’ 성소, 깜찍 미모에 건강미까지···‘매력만점 대세돌’	서울경제
유인영, 서핑화보 통해 인형외모 뒤 숨겨진 ‘섹시건강미 과시’	파이낸셜뉴스
제시, '건강미 가득한 미소'	서울경제
이시영, 건강미 넘치는 민낯…"운동하러 가고 있습니다"	머니투데이
[HI★포토] 2018 미스코리아 선 송수현 시구 “건강미 넘치는 와인드업”	한국일보
주다하 섹시화보, 터질듯한 볼륨감+11자 복근 '건강미 물씬'	한국경제TV
강예빈, 에너지 넘치는 밝은 미소... 시선 붙잡는 중... 건강미 뿜뿜	글로벌에듀
[사진](여자)아이들 미연,'돋보이는 건강미'	OSEN
[포토]화영, 어깨 살짝 노출 '건강미 넘치는 몸매'	이데일리
이채영, 컬러풀 비키니 입고 건강미 과시	OSEN
유리 화보, 건강미 넘치는 '탄탄한 S라인' 과시	머니투데이
임창정, 건강미 넘치는 미모의 여성 누구? "제주도 골프 여행 간 건 맞다"	한국경제TV
[포토] `꽃청춘-아프리카` 류준열, 건강미 넘치는 피부톤	매일경제
[WD포토] 모모랜드(MOMOLAND) 데이지, 건강미 넘치는 미모 (쇼케이스)	웹데일리
TENPHOTO, '인간중독' 조여정, 건강미 넘치는 모습으로	텐아시아
"5년째 웨이트 트레이닝"…강민경, 건강미 넘치는 사진 공개	아시아경제
김재경, 건강미 살리는 구릿빛 피부	스포츠한국
밀양요가, 장미축제 무대서 건강미 자랑	경남매일신문
조이, 넘치는 건강미 [서가대]	MK스포츠
정시아, 탐스런 머릿결에 건강미 넘치는 미모 ‘원조 삼푸 요정’	동아일보
[포토] 치어리더 '차원이 다른 건강미'	스포츠조선
[포토] 유승옥, '건강미 뽐내며 등장~'	한국경제
[포토] 씨스타 보라 '건강미 넘치는 미소'	한국경제
[bnt포토] 백진희, 건강미 돋보이는 각선미	bnt뉴스
[★포토]박은지, '건강미 넘치는 각선미'	스타뉴스
‘오늘부터 사랑해’ 임세미, 건강미 넘치는 비하인드컷…‘남다른 유연성’	MBN
‘마리텔’ 우주소녀 성소, 서핑슈트 입고 S라인 자랑…건강미 물씬	헤럴드경제
[포토] 시크릿, ‘건강미 넘치는 각선미’	파이낸셜뉴스
맹승지, `건강미 넘치는 와인드업!` [MK포토]	MK스포츠
모모랜드 연우, 가리키고 있는 것은 뭐? 건강미와 상큼함 발산... 한쪽 눈 감...	울산매일신문
축구장에서 건강미 발산한 미녀 스타 ‘왕뤄단’	인민망
코카-콜라사 ‘신체건강 W’, 건강미녀 유인나의 TV 광고 비하인드 컷 공개	로이슈
'더바디쇼2' MC 레이양, 건강미 넘치는 한가위 인사	스포츠조선
[포토] kt 치어리더 김한슬, '탄탄한 건강미 뽐내며'	스포츠조선
[포토]박준형-김지혜, '건강미 넘치는 커플'	아시아투데이
전지현 모관운동, 천송이표 건강미 비결은?	데일리안
유인영, 서핑 화보 속 숨겨진 건강미 발산…'반전 매력'	TV리포트
건강미 넘치는 에이핑크의 무대	뉴시스
[사진]김준희,'건강미 넘치는 각선미'	OSEN
도끼 혼혈, 니콜 셰르징거가 사촌?…건강미 넘치는 볼륨	MBN
[AJU포토] 디홀릭, '건강미 돋보이는 무대' (더쇼)	아주경제
이태임 `건강미 넘치는 탄력적인 바디라인` [MK포토]`	MK스포츠
“걸어서 경기도-강원도 거리” 이시영, 명성산 정상서 찰칵 [SNS★컷]	뉴스엔
드림캐처 수아, 건강미 돋보이는 각선미 [MK포토]	MK스포츠
마마무 화사, 탱크톱으로 뽐낸 건강미	스포츠한국
AOA, 자전거 모델 발탁 '건강미 통했다'	뉴스1
[MD포토] AOA 혜정 '건강미 넘치는 미모'	마이데일리
곽현화 "무시 무시한 내 등근육" 건강미 넘쳐	스타뉴스
이시영, 건강미 넘치는 등산 인증샷 "오늘 정말 열심히 했다"	경남데일리
씨스타, 감각적이고 건강미 넘치는 화보 공개 "표정 연출도 수준급"	서울경제
[NC포토] '제24회 부산국제영화제' 조여정, 건강미 넘쳐	뉴스컬처
씨스타, 건강미 넘치는 ‘기브 잇 투미’ 뮤비 미공개컷 공개	MBN
정영주 '건강미 넘치는 턴'[엑's HD포토]	엑스포츠뉴스
머슬마니아 낸시랭 1위, 터질듯한 볼륨감…건강미 '물씬!'	MBN
클레오 출신 채은정 "건강미 넘치는 몸매? 유전적 영향 커" (화보)	스포츠서울
[포토S] 하지원 치어리더, 건강미 넘치는 각선미	스포티비뉴스
한소아, 건강미 뽐낸 '고양이 자세', 어디에 좋나?	헬스조선
[포토엔]황신혜, 건강미 넘치는 탱탱함!	뉴스엔
[포토]안진경, 건강미 넘치는 바디라인	이데일리
[브릿지포토] 아몬드 브리즈 뮤즈 이하늬, '건강미 넘치는 몸매'	브릿지경제
이시영, '건강미 가득한 모습'	서울경제
씨스타 소유 vs 효린, 스포티룩 대결… 섹시+건강미	스포츠동아
[원주]도심 속 자전거 레이스 건강미 발산	강원도민일보
마마무, `건강미 넘치는 각선미 대결` [MBN포토]	MBN
씨스타 '쉐이크 잇' 티저, 탄탄한 볼륨 바디 '섹시-건강미' 절정…강균성 코믹...	스포츠조선
안다, 콜라병 몸매의 정석… 탁월한 건강미	스포츠월드
레이양, 건강미 넘치는 `무보정 볼륨몸매`	매일경제
양민화, 건강미 넘치는 애플힙 '시선강탈'	한국경제TV
아미, 건강미 넘치는 몸매 "복근까지 화제	한국경제TV
건강 미녀 유인나, 무결점 몸매 먹방 현장 포착	한국경제TV
제니퍼 로페즈 축하 공연, 10억 달러 엉덩이… 건강미 넘치네!	동아일보
[사진]유이,'건강미 넘치는 각선미 뽐내며'	OSEN
[사진]전효성,'건강미 넘치는 꿀벅지'	OSEN
효린 `건강미 넘치는 구리빛 와인드업` [MK포토]	MK스포츠
이하늬, 건강미 넘치는 화보로 시선강탈...뜨거운 남국의 태양 아래서	부산일보
신수지, 부러움 자아내는 환상 몸맵시…탄력 넘치는 건강미에 감탄사 절로	일간리더스경제
신수지, 부러움 자아내는 환상 몸맵시…탄력 넘치는 건강미에 감탄사 절로	일간리더스경제
나르샤, 레드 원피스로 드러낸 건강미 넘치는 몸매 [★해시태그]	엑스포츠뉴스
[오마이포토] 씨스타 보라, '건강미 뽐내며'	오마이뉴스
[SK포토]홍주연 선수, 운동으로 다져진 건강미	스포츠경향
제대 후 건강미 ‘뿜뿜’ 배우 주원, 아몬드 브리즈, 새 얼굴로 발탁	스포츠서울
[사진]윤예선,'건강미 넘치는 자태'(2019 머슬마니아)	OSEN
[사진]양승화,'건강미 넘치는 힙라인'(2019 머슬마니아)	OSEN
AOA 찬미, 설특집 ‘머슬퀸 프로젝트’ 출연 확정…‘건강미 발산’	한국경제
제시, 건강미 넘치는 자태 ‘시선집중’	뉴스엔
[포토] 치어리더 김연정, 건강미 넘치는 댄스!	스포츠서울
[사진]장여진,'건강미 넘치는 자태'(2019 머슬마니아)	OSEN
[bnt포토] 미쓰에이 민 '건강미 넘치는 탄탄각선미'	bnt뉴스
[사진]하주희, '건강미 넘치는 발걸음'	OSEN
씨스타 보라, 오키나와 화보…건강미 '물씬'	머니투데이
[사진]치어리더,'건강미'	OSEN
[공식입장]노홍철부터 미쓰라 부부까지" '공복자들' 7인 출연진 확정	뉴스1
[포토] 3대3 농구 '치어리더의 건강미 발산'	스포츠조선
바다, 빛나는 구리빛 건강미 [MK포토]	MK스포츠
<포토>‘2014 miss sexy back’ 건강미 넘치는 뒤태!	헤럴드경제
하용수, "김혜수 건강미 넘쳐…섹시 콘셉트 제안"	머니투데이
[사진]장여진,'건강미 넘치는 자태'(2019 머슬마니아)	OSEN
[bnt포토] 미쓰에이 민 '건강미 넘치는 탄탄각선미'	bnt뉴스
[사진]하주희, '건강미 넘치는 발걸음'	OSEN
씨스타 보라, 오키나와 화보…건강미 '물씬'	머니투데이
[사진]치어리더,'건강미'	OSEN
[공식입장]노홍철부터 미쓰라 부부까지" '공복자들' 7인 출연진 확정	뉴스1
[포토] 3대3 농구 '치어리더의 건강미 발산'	스포츠조선
바다, 빛나는 구리빛 건강미 [MK포토]	MK스포츠
<포토>‘2014 miss sexy back’ 건강미 넘치는 뒤태!	헤럴드경제
하용수, "김혜수 건강미 넘쳐…섹시 콘셉트 제안"	머니투데이
[사진]장여진,'건강미 넘치는 자태'(2019 머슬마니아)	OSEN
[bnt포토] 미쓰에이 민 '건강미 넘치는 탄탄각선미'	bnt뉴스
[사진]하주희, '건강미 넘치는 발걸음'	OSEN
씨스타 보라, 오키나와 화보…건강미 '물씬'	머니투데이
[사진]치어리더,'건강미'	OSEN
[공식입장]노홍철부터 미쓰라 부부까지" '공복자들' 7인 출연진 확정	뉴스1
[포토] 3대3 농구 '치어리더의 건강미 발산'	스포츠조선
바다, 빛나는 구리빛 건강미 [MK포토]	MK스포츠
<포토>‘2014 miss sexy back’ 건강미 넘치는 뒤태!	헤럴드경제
하용수, "김혜수 건강미 넘쳐…섹시 콘셉트 제안"	머니투데이
[사진]장여진,'건강미 넘치는 자태'(2019 머슬마니아)	OSEN
[bnt포토] 미쓰에이 민 '건강미 넘치는 탄탄각선미'	bnt뉴스
[사진]하주희, '건강미 넘치는 발걸음'	OSEN
씨스타 보라, 오키나와 화보…건강미 '물씬'	머니투데이
[사진]치어리더,'건강미'	OSEN
[공식입장]노홍철부터 미쓰라 부부까지" '공복자들' 7인 출연진 확정	뉴스1
[포토] 3대3 농구 '치어리더의 건강미 발산'	스포츠조선
바다, 빛나는 구리빛 건강미 [MK포토]	MK스포츠
<포토>‘2014 miss sexy back’ 건강미 넘치는 뒤태!	헤럴드경제
하용수, "김혜수 건강미 넘쳐…섹시 콘셉트 제안"	머니투데이
[사진]장여진,'건강미 넘치는 자태'(2019 머슬마니아)	OSEN
[bnt포토] 미쓰에이 민 '건강미 넘치는 탄탄각선미'	bnt뉴스
[사진]하주희, '건강미 넘치는 발걸음'	OSEN
씨스타 보라, 오키나와 화보…건강미 '물씬'	머니투데이
[사진]치어리더,'건강미'	OSEN
[공식입장]노홍철부터 미쓰라 부부까지" '공복자들' 7인 출연진 확정	뉴스1
[포토] 3대3 농구 '치어리더의 건강미 발산'	스포츠조선
바다, 빛나는 구리빛 건강미 [MK포토]	MK스포츠
<포토>‘2014 miss sexy back’ 건강미 넘치는 뒤태!	헤럴드경제
하용수, "김혜수 건강미 넘쳐…섹시 콘셉트 제안"	머니투데이
[사진]장여진,'건강미 넘치는 자태'(2019 머슬마니아)	OSEN
[bnt포토] 미쓰에이 민 '건강미 넘치는 탄탄각선미'	bnt뉴스
[사진]하주희, '건강미 넘치는 발걸음'	OSEN
씨스타 보라, 오키나와 화보…건강미 '물씬'	머니투데이
[사진]치어리더,'건강미'	OSEN
[공식입장]노홍철부터 미쓰라 부부까지" '공복자들' 7인 출연진 확정	뉴스1
[포토] 3대3 농구 '치어리더의 건강미 발산'	스포츠조선
바다, 빛나는 구리빛 건강미 [MK포토]	MK스포츠
<포토>‘2014 miss sexy back’ 건강미 넘치는 뒤태!	헤럴드경제
하용수, "김혜수 건강미 넘쳐…섹시 콘셉트 제안"	머니투데이
[사진]장여진,'건강미 넘치는 자태'(2019 머슬마니아)	OSEN
[bnt포토] 미쓰에이 민 '건강미 넘치는 탄탄각선미'	bnt뉴스
[사진]하주희, '건강미 넘치는 발걸음'	OSEN
씨스타 보라, 오키나와 화보…건강미 '물씬'	머니투데이
[사진]치어리더,'건강미'	OSEN
[공식입장]노홍철부터 미쓰라 부부까지" '공복자들' 7인 출연진 확정	뉴스1
[포토] 3대3 농구 '치어리더의 건강미 발산'	스포츠조선
바다, 빛나는 구리빛 건강미 [MK포토]	MK스포츠
<포토>‘2014 miss sexy back’ 건강미 넘치는 뒤태!	헤럴드경제
하용수, "김혜수 건강미 넘쳐…섹시 콘셉트 제안"	머니투데이
[사진]장여진,'건강미 넘치는 자태'(2019 머슬마니아)	OSEN
[bnt포토] 미쓰에이 민 '건강미 넘치는 탄탄각선미'	bnt뉴스
[사진]하주희, '건강미 넘치는 발걸음'	OSEN
씨스타 보라, 오키나와 화보…건강미 '물씬'	머니투데이
[사진]치어리더,'건강미'	OSEN
[공식입장]노홍철부터 미쓰라 부부까지" '공복자들' 7인 출연진 확정	뉴스1
[포토] 3대3 농구 '치어리더의 건강미 발산'	스포츠조선
바다, 빛나는 구리빛 건강미 [MK포토]	MK스포츠
<포토>‘2014 miss sexy back’ 건강미 넘치는 뒤태!	헤럴드경제
하용수, "김혜수 건강미 넘쳐…섹시 콘셉트 제안"	머니투데이
[사진]장여진,'건강미 넘치는 자태'(2019 머슬마니아)	OSEN
[bnt포토] 미쓰에이 민 '건강미 넘치는 탄탄각선미'	bnt뉴스
[사진]하주희, '건강미 넘치는 발걸음'	OSEN
씨스타 보라, 오키나와 화보…건강미 '물씬'	머니투데이
[사진]치어리더,'건강미'	OSEN
[공식입장]노홍철부터 미쓰라 부부까지" '공복자들' 7인 출연진 확정	뉴스1
[포토] 3대3 농구 '치어리더의 건강미 발산'	스포츠조선
바다, 빛나는 구리빛 건강미 [MK포토]	MK스포츠
<포토>‘2014 miss sexy back’ 건강미 넘치는 뒤태!	헤럴드경제
하용수, "김혜수 건강미 넘쳐…섹시 콘셉트 제안"	머니투데이
[사진]장여진,'건강미 넘치는 자태'(2019 머슬마니아)	OSEN
[bnt포토] 미쓰에이 민 '건강미 넘치는 탄탄각선미'	bnt뉴스
[사진]하주희, '건강미 넘치는 발걸음'	OSEN
씨스타 보라, 오키나와 화보…건강미 '물씬'	머니투데이
[사진]치어리더,'건강미'	OSEN
[공식입장]노홍철부터 미쓰라 부부까지" '공복자들' 7인 출연진 확정	뉴스1
[포토] 3대3 농구 '치어리더의 건강미 발산'	스포츠조선
바다, 빛나는 구리빛 건강미 [MK포토]	MK스포츠
<포토>‘2014 miss sexy back’ 건강미 넘치는 뒤태!	헤럴드경제
하용수, "김혜수 건강미 넘쳐…섹시 콘셉트 제안"	머니투데이
[사진]장여진,'건강미 넘치는 자태'(2019 머슬마니아)	OSEN
[bnt포토] 미쓰에이 민 '건강미 넘치는 탄탄각선미'	bnt뉴스
[사진]하주희, '건강미 넘치는 발걸음'	OSEN
씨스타 보라, 오키나와 화보…건강미 '물씬'	머니투데이
[사진]치어리더,'건강미'	OSEN
[공식입장]노홍철부터 미쓰라 부부까지" '공복자들' 7인 출연진 확정	뉴스1
[포토] 3대3 농구 '치어리더의 건강미 발산'	스포츠조선
바다, 빛나는 구리빛 건강미 [MK포토]	MK스포츠
<포토>‘2014 miss sexy back’ 건강미 넘치는 뒤태!	헤럴드경제
하용수, "김혜수 건강미 넘쳐…섹시 콘셉트 제안"	머니투데이
[사진]장여진,'건강미 넘치는 자태'(2019 머슬마니아)	OSEN
[bnt포토] 미쓰에이 민 '건강미 넘치는 탄탄각선미'	bnt뉴스
[사진]하주희, '건강미 넘치는 발걸음'	OSEN
씨스타 보라, 오키나와 화보…건강미 '물씬'	머니투데이
[사진]치어리더,'건강미'	OSEN
[공식입장]노홍철부터 미쓰라 부부까지" '공복자들' 7인 출연진 확정	뉴스1
[포토] 3대3 농구 '치어리더의 건강미 발산'	스포츠조선
바다, 빛나는 구리빛 건강미 [MK포토]	MK스포츠
<포토>‘2014 miss sexy back’ 건강미 넘치는 뒤태!	헤럴드경제
하용수, "김혜수 건강미 넘쳐…섹시 콘셉트 제안"	머니투데이
[사진]장여진,'건강미 넘치는 자태'(2019 머슬마니아)	OSEN
[bnt포토] 미쓰에이 민 '건강미 넘치는 탄탄각선미'	bnt뉴스
[사진]하주희, '건강미 넘치는 발걸음'	OSEN
씨스타 보라, 오키나와 화보…건강미 '물씬'	머니투데이
[사진]치어리더,'건강미'	OSEN
[공식입장]노홍철부터 미쓰라 부부까지" '공복자들' 7인 출연진 확정	뉴스1
[포토] 3대3 농구 '치어리더의 건강미 발산'	스포츠조선
바다, 빛나는 구리빛 건강미 [MK포토]	MK스포츠
<포토>‘2014 miss sexy back’ 건강미 넘치는 뒤태!	헤럴드경제
하용수, "김혜수 건강미 넘쳐…섹시 콘셉트 제안"	머니투데이
[사진]장여진,'건강미 넘치는 자태'(2019 머슬마니아)	OSEN
[bnt포토] 미쓰에이 민 '건강미 넘치는 탄탄각선미'	bnt뉴스
[사진]하주희, '건강미 넘치는 발걸음'	OSEN
씨스타 보라, 오키나와 화보…건강미 '물씬'	머니투데이
[사진]치어리더,'건강미'	OSEN
[공식입장]노홍철부터 미쓰라 부부까지" '공복자들' 7인 출연진 확정	뉴스1
[포토] 3대3 농구 '치어리더의 건강미 발산'	스포츠조선
바다, 빛나는 구리빛 건강미 [MK포토]	MK스포츠
<포토>‘2014 miss sexy back’ 건강미 넘치는 뒤태!	헤럴드경제
하용수, "김혜수 건강미 넘쳐…섹시 콘셉트 제안"	머니투데이
[사진]장여진,'건강미 넘치는 자태'(2019 머슬마니아)	OSEN
[bnt포토] 미쓰에이 민 '건강미 넘치는 탄탄각선미'	bnt뉴스
[사진]하주희, '건강미 넘치는 발걸음'	OSEN
씨스타 보라, 오키나와 화보…건강미 '물씬'	머니투데이
[사진]치어리더,'건강미'	OSEN
[공식입장]노홍철부터 미쓰라 부부까지" '공복자들' 7인 출연진 확정	뉴스1
[포토] 3대3 농구 '치어리더의 건강미 발산'	스포츠조선
바다, 빛나는 구리빛 건강미 [MK포토]	MK스포츠
<포토>‘2014 miss sexy back’ 건강미 넘치는 뒤태!	헤럴드경제
하용수, "김혜수 건강미 넘쳐…섹시 콘셉트 제안"	머니투데이
[사진]장여진,'건강미 넘치는 자태'(2019 머슬마니아)	OSEN
[bnt포토] 미쓰에이 민 '건강미 넘치는 탄탄각선미'	bnt뉴스
[사진]하주희, '건강미 넘치는 발걸음'	OSEN
씨스타 보라, 오키나와 화보…건강미 '물씬'	머니투데이
[사진]치어리더,'건강미'	OSEN
[공식입장]노홍철부터 미쓰라 부부까지" '공복자들' 7인 출연진 확정	뉴스1
[포토] 3대3 농구 '치어리더의 건강미 발산'	스포츠조선
바다, 빛나는 구리빛 건강미 [MK포토]	MK스포츠
<포토>‘2014 miss sexy back’ 건강미 넘치는 뒤태!	헤럴드경제
하용수, "김혜수 건강미 넘쳐…섹시 콘셉트 제안"	머니투데이
[사진]장여진,'건강미 넘치는 자태'(2019 머슬마니아)	OSEN
[bnt포토] 미쓰에이 민 '건강미 넘치는 탄탄각선미'	bnt뉴스
[사진]하주희, '건강미 넘치는 발걸음'	OSEN
씨스타 보라, 오키나와 화보…건강미 '물씬'	머니투데이
[사진]치어리더,'건강미'	OSEN
[공식입장]노홍철부터 미쓰라 부부까지" '공복자들' 7인 출연진 확정	뉴스1
[포토] 3대3 농구 '치어리더의 건강미 발산'	스포츠조선
바다, 빛나는 구리빛 건강미 [MK포토]	MK스포츠
<포토>‘2014 miss sexy back’ 건강미 넘치는 뒤태!	헤럴드경제
하용수, "김혜수 건강미 넘쳐…섹시 콘셉트 제안"	머니투데이
[사진]장여진,'건강미 넘치는 자태'(2019 머슬마니아)	OSEN
[bnt포토] 미쓰에이 민 '건강미 넘치는 탄탄각선미'	bnt뉴스
[사진]하주희, '건강미 넘치는 발걸음'	OSEN
씨스타 보라, 오키나와 화보…건강미 '물씬'	머니투데이
[사진]치어리더,'건강미'	OSEN
[공식입장]노홍철부터 미쓰라 부부까지" '공복자들' 7인 출연진 확정	뉴스1
[포토] 3대3 농구 '치어리더의 건강미 발산'	스포츠조선
바다, 빛나는 구리빛 건강미 [MK포토]	MK스포츠
<포토>‘2014 miss sexy back’ 건강미 넘치는 뒤태!	헤럴드경제
하용수, "김혜수 건강미 넘쳐…섹시 콘셉트 제안"	머니투데이
[사진]장여진,'건강미 넘치는 자태'(2019 머슬마니아)	OSEN
[bnt포토] 미쓰에이 민 '건강미 넘치는 탄탄각선미'	bnt뉴스
[사진]하주희, '건강미 넘치는 발걸음'	OSEN
씨스타 보라, 오키나와 화보…건강미 '물씬'	머니투데이
[사진]치어리더,'건강미'	OSEN
[공식입장]노홍철부터 미쓰라 부부까지" '공복자들' 7인 출연진 확정	뉴스1
[포토] 3대3 농구 '치어리더의 건강미 발산'	스포츠조선
바다, 빛나는 구리빛 건강미 [MK포토]	MK스포츠
<포토>‘2014 miss sexy back’ 건강미 넘치는 뒤태!	헤럴드경제
하용수, "김혜수 건강미 넘쳐…섹시 콘셉트 제안"	머니투데이
[사진]장여진,'건강미 넘치는 자태'(2019 머슬마니아)	OSEN
[bnt포토] 미쓰에이 민 '건강미 넘치는 탄탄각선미'	bnt뉴스
[사진]하주희, '건강미 넘치는 발걸음'	OSEN
씨스타 보라, 오키나와 화보…건강미 '물씬'	머니투데이
[사진]치어리더,'건강미'	OSEN
[공식입장]노홍철부터 미쓰라 부부까지" '공복자들' 7인 출연진 확정	뉴스1
[포토] 3대3 농구 '치어리더의 건강미 발산'	스포츠조선
바다, 빛나는 구리빛 건강미 [MK포토]	MK스포츠
<포토>‘2014 miss sexy back’ 건강미 넘치는 뒤태!	헤럴드경제
하용수, "김혜수 건강미 넘쳐…섹시 콘셉트 제안"	머니투데이
[사진]장여진,'건강미 넘치는 자태'(2019 머슬마니아)	OSEN
[bnt포토] 미쓰에이 민 '건강미 넘치는 탄탄각선미'	bnt뉴스
[사진]하주희, '건강미 넘치는 발걸음'	OSEN
씨스타 보라, 오키나와 화보…건강미 '물씬'	머니투데이
[사진]치어리더,'건강미'	OSEN
[공식입장]노홍철부터 미쓰라 부부까지" '공복자들' 7인 출연진 확정	뉴스1
[포토] 3대3 농구 '치어리더의 건강미 발산'	스포츠조선
바다, 빛나는 구리빛 건강미 [MK포토]	MK스포츠
<포토>‘2014 miss sexy back’ 건강미 넘치는 뒤태!	헤럴드경제
하용수, "김혜수 건강미 넘쳐…섹시 콘셉트 제안"	머니투데이
[사진]장여진,'건강미 넘치는 자태'(2019 머슬마니아)	OSEN
[bnt포토] 미쓰에이 민 '건강미 넘치는 탄탄각선미'	bnt뉴스
[사진]하주희, '건강미 넘치는 발걸음'	OSEN
씨스타 보라, 오키나와 화보…건강미 '물씬'	머니투데이
[사진]치어리더,'건강미'	OSEN
[공식입장]노홍철부터 미쓰라 부부까지" '공복자들' 7인 출연진 확정	뉴스1
[포토] 3대3 농구 '치어리더의 건강미 발산'	스포츠조선
바다, 빛나는 구리빛 건강미 [MK포토]	MK스포츠
<포토>‘2014 miss sexy back’ 건강미 넘치는 뒤태!	헤럴드경제
하용수, "김혜수 건강미 넘쳐…섹시 콘셉트 제안"	머니투데이
[사진]장여진,'건강미 넘치는 자태'(2019 머슬마니아)	OSEN
[bnt포토] 미쓰에이 민 '건강미 넘치는 탄탄각선미'	bnt뉴스
[사진]하주희, '건강미 넘치는 발걸음'	OSEN
씨스타 보라, 오키나와 화보…건강미 '물씬'	머니투데이
[사진]치어리더,'건강미'	OSEN
[공식입장]노홍철부터 미쓰라 부부까지" '공복자들' 7인 출연진 확정	뉴스1
[포토] 3대3 농구 '치어리더의 건강미 발산'	스포츠조선
바다, 빛나는 구리빛 건강미 [MK포토]	MK스포츠
<포토>‘2014 miss sexy back’ 건강미 넘치는 뒤태!	헤럴드경제
하용수, "김혜수 건강미 넘쳐…섹시 콘셉트 제안"	머니투데이
[사진]장여진,'건강미 넘치는 자태'(2019 머슬마니아)	OSEN
[bnt포토] 미쓰에이 민 '건강미 넘치는 탄탄각선미'	bnt뉴스
[사진]하주희, '건강미 넘치는 발걸음'	OSEN
씨스타 보라, 오키나와 화보…건강미 '물씬'	머니투데이
[사진]치어리더,'건강미'	OSEN
[공식입장]노홍철부터 미쓰라 부부까지" '공복자들' 7인 출연진 확정	뉴스1
[포토] 3대3 농구 '치어리더의 건강미 발산'	스포츠조선
바다, 빛나는 구리빛 건강미 [MK포토]	MK스포츠
<포토>‘2014 miss sexy back’ 건강미 넘치는 뒤태!	헤럴드경제
하용수, "김혜수 건강미 넘쳐…섹시 콘셉트 제안"	머니투데이
[사진]장여진,'건강미 넘치는 자태'(2019 머슬마니아)	OSEN
[bnt포토] 미쓰에이 민 '건강미 넘치는 탄탄각선미'	bnt뉴스
[사진]하주희, '건강미 넘치는 발걸음'	OSEN
씨스타 보라, 오키나와 화보…건강미 '물씬'	머니투데이
[사진]치어리더,'건강미'	OSEN
[공식입장]노홍철부터 미쓰라 부부까지" '공복자들' 7인 출연진 확정	뉴스1
[포토] 3대3 농구 '치어리더의 건강미 발산'	스포츠조선
바다, 빛나는 구리빛 건강미 [MK포토]	MK스포츠
<포토>‘2014 miss sexy back’ 건강미 넘치는 뒤태!	헤럴드경제
하용수, "김혜수 건강미 넘쳐…섹시 콘셉트 제안"	머니투데이
[사진]장여진,'건강미 넘치는 자태'(2019 머슬마니아)	OSEN
[bnt포토] 미쓰에이 민 '건강미 넘치는 탄탄각선미'	bnt뉴스
[사진]하주희, '건강미 넘치는 발걸음'	OSEN
씨스타 보라, 오키나와 화보…건강미 '물씬'	머니투데이
[사진]치어리더,'건강미'	OSEN
[공식입장]노홍철부터 미쓰라 부부까지" '공복자들' 7인 출연진 확정	뉴스1
[포토] 3대3 농구 '치어리더의 건강미 발산'	스포츠조선
바다, 빛나는 구리빛 건강미 [MK포토]	MK스포츠
<포토>‘2014 miss sexy back’ 건강미 넘치는 뒤태!	헤럴드경제
하용수, "김혜수 건강미 넘쳐…섹시 콘셉트 제안"	머니투데이
[사진]장여진,'건강미 넘치는 자태'(2019 머슬마니아)	OSEN
[bnt포토] 미쓰에이 민 '건강미 넘치는 탄탄각선미'	bnt뉴스
[사진]하주희, '건강미 넘치는 발걸음'	OSEN
씨스타 보라, 오키나와 화보…건강미 '물씬'	머니투데이
[사진]치어리더,'건강미'	OSEN
[공식입장]노홍철부터 미쓰라 부부까지" '공복자들' 7인 출연진 확정	뉴스1
[포토] 3대3 농구 '치어리더의 건강미 발산'	스포츠조선
바다, 빛나는 구리빛 건강미 [MK포토]	MK스포츠
<포토>‘2014 miss sexy back’ 건강미 넘치는 뒤태!	헤럴드경제
하용수, "김혜수 건강미 넘쳐…섹시 콘셉트 제안"	머니투데이
[사진]장여진,'건강미 넘치는 자태'(2019 머슬마니아)	OSEN
[bnt포토] 미쓰에이 민 '건강미 넘치는 탄탄각선미'	bnt뉴스
[사진]하주희, '건강미 넘치는 발걸음'	OSEN
씨스타 보라, 오키나와 화보…건강미 '물씬'	머니투데이
[사진]치어리더,'건강미'	OSEN
[공식입장]노홍철부터 미쓰라 부부까지" '공복자들' 7인 출연진 확정	뉴스1
[포토] 3대3 농구 '치어리더의 건강미 발산'	스포츠조선
바다, 빛나는 구리빛 건강미 [MK포토]	MK스포츠
<포토>‘2014 miss sexy back’ 건강미 넘치는 뒤태!	헤럴드경제
하용수, "김혜수 건강미 넘쳐…섹시 콘셉트 제안"	머니투데이
[사진]장여진,'건강미 넘치는 자태'(2019 머슬마니아)	OSEN
[bnt포토] 미쓰에이 민 '건강미 넘치는 탄탄각선미'	bnt뉴스
[사진]하주희, '건강미 넘치는 발걸음'	OSEN
씨스타 보라, 오키나와 화보…건강미 '물씬'	머니투데이
[사진]치어리더,'건강미'	OSEN
[공식입장]노홍철부터 미쓰라 부부까지" '공복자들' 7인 출연진 확정	뉴스1
[포토] 3대3 농구 '치어리더의 건강미 발산'	스포츠조선
바다, 빛나는 구리빛 건강미 [MK포토]	MK스포츠
<포토>‘2014 miss sexy back’ 건강미 넘치는 뒤태!	헤럴드경제
하용수, "김혜수 건강미 넘쳐…섹시 콘셉트 제안"	머니투데이
[사진]장여진,'건강미 넘치는 자태'(2019 머슬마니아)	OSEN
[bnt포토] 미쓰에이 민 '건강미 넘치는 탄탄각선미'	bnt뉴스
[사진]하주희, '건강미 넘치는 발걸음'	OSEN
씨스타 보라, 오키나와 화보…건강미 '물씬'	머니투데이
[사진]치어리더,'건강미'	OSEN
[공식입장]노홍철부터 미쓰라 부부까지" '공복자들' 7인 출연진 확정	뉴스1
[포토] 3대3 농구 '치어리더의 건강미 발산'	스포츠조선
바다, 빛나는 구리빛 건강미 [MK포토]	MK스포츠
<포토>‘2014 miss sexy back’ 건강미 넘치는 뒤태!	헤럴드경제
하용수, "김혜수 건강미 넘쳐…섹시 콘셉트 제안"	머니투데이
[사진]장여진,'건강미 넘치는 자태'(2019 머슬마니아)	OSEN
[bnt포토] 미쓰에이 민 '건강미 넘치는 탄탄각선미'	bnt뉴스
[사진]하주희, '건강미 넘치는 발걸음'	OSEN
씨스타 보라, 오키나와 화보…건강미 '물씬'	머니투데이
[사진]치어리더,'건강미'	OSEN
[공식입장]노홍철부터 미쓰라 부부까지" '공복자들' 7인 출연진 확정	뉴스1
[포토] 3대3 농구 '치어리더의 건강미 발산'	스포츠조선
바다, 빛나는 구리빛 건강미 [MK포토]	MK스포츠
<포토>‘2014 miss sexy back’ 건강미 넘치는 뒤태!	헤럴드경제
하용수, "김혜수 건강미 넘쳐…섹시 콘셉트 제안"	머니투데이
[사진]장여진,'건강미 넘치는 자태'(2019 머슬마니아)	OSEN
[bnt포토] 미쓰에이 민 '건강미 넘치는 탄탄각선미'	bnt뉴스
[사진]하주희, '건강미 넘치는 발걸음'	OSEN
씨스타 보라, 오키나와 화보…건강미 '물씬'	머니투데이
[사진]치어리더,'건강미'	OSEN
[공식입장]노홍철부터 미쓰라 부부까지" '공복자들' 7인 출연진 확정	뉴스1
[포토] 3대3 농구 '치어리더의 건강미 발산'	스포츠조선
바다, 빛나는 구리빛 건강미 [MK포토]	MK스포츠
<포토>‘2014 miss sexy back’ 건강미 넘치는 뒤태!	헤럴드경제
하용수, "김혜수 건강미 넘쳐…섹시 콘셉트 제안"	머니투데이
[사진]장여진,'건강미 넘치는 자태'(2019 머슬마니아)	OSEN
[bnt포토] 미쓰에이 민 '건강미 넘치는 탄탄각선미'	bnt뉴스
[사진]하주희, '건강미 넘치는 발걸음'	OSEN
씨스타 보라, 오키나와 화보…건강미 '물씬'	머니투데이
[사진]치어리더,'건강미'	OSEN
[공식입장]노홍철부터 미쓰라 부부까지" '공복자들' 7인 출연진 확정	뉴스1
[포토] 3대3 농구 '치어리더의 건강미 발산'	스포츠조선
바다, 빛나는 구리빛 건강미 [MK포토]	MK스포츠
<포토>‘2014 miss sexy back’ 건강미 넘치는 뒤태!	헤럴드경제
하용수, "김혜수 건강미 넘쳐…섹시 콘셉트 제안"	머니투데이
[사진]장여진,'건강미 넘치는 자태'(2019 머슬마니아)	OSEN
[bnt포토] 미쓰에이 민 '건강미 넘치는 탄탄각선미'	bnt뉴스
[사진]하주희, '건강미 넘치는 발걸음'	OSEN
씨스타 보라, 오키나와 화보…건강미 '물씬'	머니투데이
[사진]치어리더,'건강미'	OSEN
[공식입장]노홍철부터 미쓰라 부부까지" '공복자들' 7인 출연진 확정	뉴스1
[포토] 3대3 농구 '치어리더의 건강미 발산'	스포츠조선
바다, 빛나는 구리빛 건강미 [MK포토]	MK스포츠
<포토>‘2014 miss sexy back’ 건강미 넘치는 뒤태!	헤럴드경제
하용수, "김혜수 건강미 넘쳐…섹시 콘셉트 제안"	머니투데이
[사진]장여진,'건강미 넘치는 자태'(2019 머슬마니아)	OSEN
[bnt포토] 미쓰에이 민 '건강미 넘치는 탄탄각선미'	bnt뉴스
[사진]하주희, '건강미 넘치는 발걸음'	OSEN
씨스타 보라, 오키나와 화보…건강미 '물씬'	머니투데이
[사진]치어리더,'건강미'	OSEN
[공식입장]노홍철부터 미쓰라 부부까지" '공복자들' 7인 출연진 확정	뉴스1
[포토] 3대3 농구 '치어리더의 건강미 발산'	스포츠조선
바다, 빛나는 구리빛 건강미 [MK포토]	MK스포츠
<포토>‘2014 miss sexy back’ 건강미 넘치는 뒤태!	헤럴드경제
하용수, "김혜수 건강미 넘쳐…섹시 콘셉트 제안"	머니투데이
[사진]장여진,'건강미 넘치는 자태'(2019 머슬마니아)	OSEN
[bnt포토] 미쓰에이 민 '건강미 넘치는 탄탄각선미'	bnt뉴스
[사진]하주희, '건강미 넘치는 발걸음'	OSEN
씨스타 보라, 오키나와 화보…건강미 '물씬'	머니투데이
[사진]치어리더,'건강미'	OSEN
[공식입장]노홍철부터 미쓰라 부부까지" '공복자들' 7인 출연진 확정	뉴스1
[포토] 3대3 농구 '치어리더의 건강미 발산'	스포츠조선
바다, 빛나는 구리빛 건강미 [MK포토]	MK스포츠
<포토>‘2014 miss sexy back’ 건강미 넘치는 뒤태!	헤럴드경제
하용수, "김혜수 건강미 넘쳐…섹시 콘셉트 제안"	머니투데이
[사진]장여진,'건강미 넘치는 자태'(2019 머슬마니아)	OSEN
[bnt포토] 미쓰에이 민 '건강미 넘치는 탄탄각선미'	bnt뉴스
[사진]하주희, '건강미 넘치는 발걸음'	OSEN
씨스타 보라, 오키나와 화보…건강미 '물씬'	머니투데이
[사진]치어리더,'건강미'	OSEN
[공식입장]노홍철부터 미쓰라 부부까지" '공복자들' 7인 출연진 확정	뉴스1
[포토] 3대3 농구 '치어리더의 건강미 발산'	스포츠조선
바다, 빛나는 구리빛 건강미 [MK포토]	MK스포츠
<포토>‘2014 miss sexy back’ 건강미 넘치는 뒤태!	헤럴드경제
하용수, "김혜수 건강미 넘쳐…섹시 콘셉트 제안"	머니투데이
[사진]장여진,'건강미 넘치는 자태'(2019 머슬마니아)	OSEN
[bnt포토] 미쓰에이 민 '건강미 넘치는 탄탄각선미'	bnt뉴스
[사진]하주희, '건강미 넘치는 발걸음'	OSEN
씨스타 보라, 오키나와 화보…건강미 '물씬'	머니투데이
[사진]치어리더,'건강미'	OSEN
[공식입장]노홍철부터 미쓰라 부부까지" '공복자들' 7인 출연진 확정	뉴스1
[포토] 3대3 농구 '치어리더의 건강미 발산'	스포츠조선
바다, 빛나는 구리빛 건강미 [MK포토]	MK스포츠
<포토>‘2014 miss sexy back’ 건강미 넘치는 뒤태!	헤럴드경제
하용수, "김혜수 건강미 넘쳐…섹시 콘셉트 제안"	머니투데이
[사진]장여진,'건강미 넘치는 자태'(2019 머슬마니아)	OSEN
[bnt포토] 미쓰에이 민 '건강미 넘치는 탄탄각선미'	bnt뉴스
[사진]하주희, '건강미 넘치는 발걸음'	OSEN
씨스타 보라, 오키나와 화보…건강미 '물씬'	머니투데이
[사진]치어리더,'건강미'	OSEN
[공식입장]노홍철부터 미쓰라 부부까지" '공복자들' 7인 출연진 확정	뉴스1
[포토] 3대3 농구 '치어리더의 건강미 발산'	스포츠조선
바다, 빛나는 구리빛 건강미 [MK포토]	MK스포츠
<포토>‘2014 miss sexy back’ 건강미 넘치는 뒤태!	헤럴드경제
하용수, "김혜수 건강미 넘쳐…섹시 콘셉트 제안"	머니투데이
[사진]장여진,'건강미 넘치는 자태'(2019 머슬마니아)	OSEN
[bnt포토] 미쓰에이 민 '건강미 넘치는 탄탄각선미'	bnt뉴스
[사진]하주희, '건강미 넘치는 발걸음'	OSEN
씨스타 보라, 오키나와 화보…건강미 '물씬'	머니투데이
[사진]치어리더,'건강미'	OSEN
[공식입장]노홍철부터 미쓰라 부부까지" '공복자들' 7인 출연진 확정	뉴스1
[포토] 3대3 농구 '치어리더의 건강미 발산'	스포츠조선
바다, 빛나는 구리빛 건강미 [MK포토]	MK스포츠
<포토>‘2014 miss sexy back’ 건강미 넘치는 뒤태!	헤럴드경제
하용수, "김혜수 건강미 넘쳐…섹시 콘셉트 제안"	머니투데이
[사진]장여진,'건강미 넘치는 자태'(2019 머슬마니아)	OSEN
[bnt포토] 미쓰에이 민 '건강미 넘치는 탄탄각선미'	bnt뉴스
[사진]하주희, '건강미 넘치는 발걸음'	OSEN
씨스타 보라, 오키나와 화보…건강미 '물씬'	머니투데이
[사진]치어리더,'건강미'	OSEN
[공식입장]노홍철부터 미쓰라 부부까지" '공복자들' 7인 출연진 확정	뉴스1
[포토] 3대3 농구 '치어리더의 건강미 발산'	스포츠조선
바다, 빛나는 구리빛 건강미 [MK포토]	MK스포츠
<포토>‘2014 miss sexy back’ 건강미 넘치는 뒤태!	헤럴드경제
하용수, "김혜수 건강미 넘쳐…섹시 콘셉트 제안"	머니투데이
[사진]장여진,'건강미 넘치는 자태'(2019 머슬마니아)	OSEN
[bnt포토] 미쓰에이 민 '건강미 넘치는 탄탄각선미'	bnt뉴스
[사진]하주희, '건강미 넘치는 발걸음'	OSEN
씨스타 보라, 오키나와 화보…건강미 '물씬'	머니투데이
[사진]치어리더,'건강미'	OSEN
[공식입장]노홍철부터 미쓰라 부부까지" '공복자들' 7인 출연진 확정	뉴스1
[포토] 3대3 농구 '치어리더의 건강미 발산'	스포츠조선
바다, 빛나는 구리빛 건강미 [MK포토]	MK스포츠
<포토>‘2014 miss sexy back’ 건강미 넘치는 뒤태!	헤럴드경제
하용수, "김혜수 건강미 넘쳐…섹시 콘셉트 제안"	머니투데이
[사진]장여진,'건강미 넘치는 자태'(2019 머슬마니아)	OSEN
[bnt포토] 미쓰에이 민 '건강미 넘치는 탄탄각선미'	bnt뉴스
[사진]하주희, '건강미 넘치는 발걸음'	OSEN
씨스타 보라, 오키나와 화보…건강미 '물씬'	머니투데이
[사진]치어리더,'건강미'	OSEN
[공식입장]노홍철부터 미쓰라 부부까지" '공복자들' 7인 출연진 확정	뉴스1
[포토] 3대3 농구 '치어리더의 건강미 발산'	스포츠조선
바다, 빛나는 구리빛 건강미 [MK포토]	MK스포츠
<포토>‘2014 miss sexy back’ 건강미 넘치는 뒤태!	헤럴드경제
하용수, "김혜수 건강미 넘쳐…섹시 콘셉트 제안"	머니투데이
[사진]장여진,'건강미 넘치는 자태'(2019 머슬마니아)	OSEN
[bnt포토] 미쓰에이 민 '건강미 넘치는 탄탄각선미'	bnt뉴스
[사진]하주희, '건강미 넘치는 발걸음'	OSEN
씨스타 보라, 오키나와 화보…건강미 '물씬'	머니투데이
[사진]치어리더,'건강미'	OSEN
[공식입장]노홍철부터 미쓰라 부부까지" '공복자들' 7인 출연진 확정	뉴스1
[포토] 3대3 농구 '치어리더의 건강미 발산'	스포츠조선
바다, 빛나는 구리빛 건강미 [MK포토]	MK스포츠
<포토>‘2014 miss sexy back’ 건강미 넘치는 뒤태!	헤럴드경제
하용수, "김혜수 건강미 넘쳐…섹시 콘셉트 제안"	머니투데이
[사진]장여진,'건강미 넘치는 자태'(2019 머슬마니아)	OSEN
[bnt포토] 미쓰에이 민 '건강미 넘치는 탄탄각선미'	bnt뉴스
[사진]하주희, '건강미 넘치는 발걸음'	OSEN
씨스타 보라, 오키나와 화보…건강미 '물씬'	머니투데이
[사진]치어리더,'건강미'	OSEN
[공식입장]노홍철부터 미쓰라 부부까지" '공복자들' 7인 출연진 확정	뉴스1
[포토] 3대3 농구 '치어리더의 건강미 발산'	스포츠조선
바다, 빛나는 구리빛 건강미 [MK포토]	MK스포츠
<포토>‘2014 miss sexy back’ 건강미 넘치는 뒤태!	헤럴드경제
하용수, "김혜수 건강미 넘쳐…섹시 콘셉트 제안"	머니투데이
[사진]장여진,'건강미 넘치는 자태'(2019 머슬마니아)	OSEN
[bnt포토] 미쓰에이 민 '건강미 넘치는 탄탄각선미'	bnt뉴스
[사진]하주희, '건강미 넘치는 발걸음'	OSEN
씨스타 보라, 오키나와 화보…건강미 '물씬'	머니투데이
[사진]치어리더,'건강미'	OSEN
[공식입장]노홍철부터 미쓰라 부부까지" '공복자들' 7인 출연진 확정	뉴스1
[포토] 3대3 농구 '치어리더의 건강미 발산'	스포츠조선
바다, 빛나는 구리빛 건강미 [MK포토]	MK스포츠
<포토>‘2014 miss sexy back’ 건강미 넘치는 뒤태!	헤럴드경제
하용수, "김혜수 건강미 넘쳐…섹시 콘셉트 제안"	머니투데이
[사진]장여진,'건강미 넘치는 자태'(2019 머슬마니아)	OSEN
[bnt포토] 미쓰에이 민 '건강미 넘치는 탄탄각선미'	bnt뉴스
[사진]하주희, '건강미 넘치는 발걸음'	OSEN
씨스타 보라, 오키나와 화보…건강미 '물씬'	머니투데이
[사진]치어리더,'건강미'	OSEN
[공식입장]노홍철부터 미쓰라 부부까지" '공복자들' 7인 출연진 확정	뉴스1
[포토] 3대3 농구 '치어리더의 건강미 발산'	스포츠조선
바다, 빛나는 구리빛 건강미 [MK포토]	MK스포츠
<포토>‘2014 miss sexy back’ 건강미 넘치는 뒤태!	헤럴드경제
하용수, "김혜수 건강미 넘쳐…섹시 콘셉트 제안"	머니투데이
[사진]장여진,'건강미 넘치는 자태'(2019 머슬마니아)	OSEN
[bnt포토] 미쓰에이 민 '건강미 넘치는 탄탄각선미'	bnt뉴스
[사진]하주희, '건강미 넘치는 발걸음'	OSEN
씨스타 보라, 오키나와 화보…건강미 '물씬'	머니투데이
[사진]치어리더,'건강미'	OSEN
[공식입장]노홍철부터 미쓰라 부부까지" '공복자들' 7인 출연진 확정	뉴스1
[포토] 3대3 농구 '치어리더의 건강미 발산'	스포츠조선
바다, 빛나는 구리빛 건강미 [MK포토]	MK스포츠
<포토>‘2014 miss sexy back’ 건강미 넘치는 뒤태!	헤럴드경제
하용수, "김혜수 건강미 넘쳐…섹시 콘셉트 제안"	머니투데이
[사진]장여진,'건강미 넘치는 자태'(2019 머슬마니아)	OSEN
[bnt포토] 미쓰에이 민 '건강미 넘치는 탄탄각선미'	bnt뉴스
[사진]하주희, '건강미 넘치는 발걸음'	OSEN
씨스타 보라, 오키나와 화보…건강미 '물씬'	머니투데이
[사진]치어리더,'건강미'	OSEN
[공식입장]노홍철부터 미쓰라 부부까지" '공복자들' 7인 출연진 확정	뉴스1
[포토] 3대3 농구 '치어리더의 건강미 발산'	스포츠조선
바다, 빛나는 구리빛 건강미 [MK포토]	MK스포츠
<포토>‘2014 miss sexy back’ 건강미 넘치는 뒤태!	헤럴드경제
하용수, "김혜수 건강미 넘쳐…섹시 콘셉트 제안"	머니투데이
[사진]장여진,'건강미 넘치는 자태'(2019 머슬마니아)	OSEN
[bnt포토] 미쓰에이 민 '건강미 넘치는 탄탄각선미'	bnt뉴스
[사진]하주희, '건강미 넘치는 발걸음'	OSEN
씨스타 보라, 오키나와 화보…건강미 '물씬'	머니투데이
[사진]치어리더,'건강미'	OSEN
[공식입장]노홍철부터 미쓰라 부부까지" '공복자들' 7인 출연진 확정	뉴스1
[포토] 3대3 농구 '치어리더의 건강미 발산'	스포츠조선
바다, 빛나는 구리빛 건강미 [MK포토]	MK스포츠
<포토>‘2014 miss sexy back’ 건강미 넘치는 뒤태!	헤럴드경제
하용수, "김혜수 건강미 넘쳐…섹시 콘셉트 제안"	머니투데이
[사진]장여진,'건강미 넘치는 자태'(2019 머슬마니아)	OSEN
[bnt포토] 미쓰에이 민 '건강미 넘치는 탄탄각선미'	bnt뉴스
[사진]하주희, '건강미 넘치는 발걸음'	OSEN
씨스타 보라, 오키나와 화보…건강미 '물씬'	머니투데이
[사진]치어리더,'건강미'	OSEN
[공식입장]노홍철부터 미쓰라 부부까지" '공복자들' 7인 출연진 확정	뉴스1
[포토] 3대3 농구 '치어리더의 건강미 발산'	스포츠조선
바다, 빛나는 구리빛 건강미 [MK포토]	MK스포츠
<포토>‘2014 miss sexy back’ 건강미 넘치는 뒤태!	헤럴드경제
하용수, "김혜수 건강미 넘쳐…섹시 콘셉트 제안"	머니투데이
[사진]장여진,'건강미 넘치는 자태'(2019 머슬마니아)	OSEN
[bnt포토] 미쓰에이 민 '건강미 넘치는 탄탄각선미'	bnt뉴스
[사진]하주희, '건강미 넘치는 발걸음'	OSEN
씨스타 보라, 오키나와 화보…건강미 '물씬'	머니투데이
[사진]치어리더,'건강미'	OSEN
[공식입장]노홍철부터 미쓰라 부부까지" '공복자들' 7인 출연진 확정	뉴스1
[포토] 3대3 농구 '치어리더의 건강미 발산'	스포츠조선
바다, 빛나는 구리빛 건강미 [MK포토]	MK스포츠
<포토>‘2014 miss sexy back’ 건강미 넘치는 뒤태!	헤럴드경제
하용수, "김혜수 건강미 넘쳐…섹시 콘셉트 제안"	머니투데이
[사진]장여진,'건강미 넘치는 자태'(2019 머슬마니아)	OSEN
[bnt포토] 미쓰에이 민 '건강미 넘치는 탄탄각선미'	bnt뉴스
[사진]하주희, '건강미 넘치는 발걸음'	OSEN
씨스타 보라, 오키나와 화보…건강미 '물씬'	머니투데이
[사진]치어리더,'건강미'	OSEN
[공식입장]노홍철부터 미쓰라 부부까지" '공복자들' 7인 출연진 확정	뉴스1
[포토] 3대3 농구 '치어리더의 건강미 발산'	스포츠조선
바다, 빛나는 구리빛 건강미 [MK포토]	MK스포츠
<포토>‘2014 miss sexy back’ 건강미 넘치는 뒤태!	헤럴드경제
하용수, "김혜수 건강미 넘쳐…섹시 콘셉트 제안"	머니투데이
[사진]장여진,'건강미 넘치는 자태'(2019 머슬마니아)	OSEN
[bnt포토] 미쓰에이 민 '건강미 넘치는 탄탄각선미'	bnt뉴스
[사진]하주희, '건강미 넘치는 발걸음'	OSEN
씨스타 보라, 오키나와 화보…건강미 '물씬'	머니투데이
[사진]치어리더,'건강미'	OSEN
[공식입장]노홍철부터 미쓰라 부부까지" '공복자들' 7인 출연진 확정	뉴스1
[포토] 3대3 농구 '치어리더의 건강미 발산'	스포츠조선
바다, 빛나는 구리빛 건강미 [MK포토]	MK스포츠
<포토>‘2014 miss sexy back’ 건강미 넘치는 뒤태!	헤럴드경제
하용수, "김혜수 건강미 넘쳐…섹시 콘셉트 제안"	머니투데이
[사진]장여진,'건강미 넘치는 자태'(2019 머슬마니아)	OSEN
[bnt포토] 미쓰에이 민 '건강미 넘치는 탄탄각선미'	bnt뉴스
[사진]하주희, '건강미 넘치는 발걸음'	OSEN
씨스타 보라, 오키나와 화보…건강미 '물씬'	머니투데이
[사진]치어리더,'건강미'	OSEN
[공식입장]노홍철부터 미쓰라 부부까지" '공복자들' 7인 출연진 확정	뉴스1
[포토] 3대3 농구 '치어리더의 건강미 발산'	스포츠조선
바다, 빛나는 구리빛 건강미 [MK포토]	MK스포츠
<포토>‘2014 miss sexy back’ 건강미 넘치는 뒤태!	헤럴드경제
하용수, "김혜수 건강미 넘쳐…섹시 콘셉트 제안"	머니투데이
[사진]장여진,'건강미 넘치는 자태'(2019 머슬마니아)	OSEN
[bnt포토] 미쓰에이 민 '건강미 넘치는 탄탄각선미'	bnt뉴스
[사진]하주희, '건강미 넘치는 발걸음'	OSEN
씨스타 보라, 오키나와 화보…건강미 '물씬'	머니투데이
[사진]치어리더,'건강미'	OSEN
[공식입장]노홍철부터 미쓰라 부부까지" '공복자들' 7인 출연진 확정	뉴스1
[포토] 3대3 농구 '치어리더의 건강미 발산'	스포츠조선
바다, 빛나는 구리빛 건강미 [MK포토]	MK스포츠
<포토>‘2014 miss sexy back’ 건강미 넘치는 뒤태!	헤럴드경제
하용수, "김혜수 건강미 넘쳐…섹시 콘셉트 제안"	머니투데이
[사진]장여진,'건강미 넘치는 자태'(2019 머슬마니아)	OSEN
[bnt포토] 미쓰에이 민 '건강미 넘치는 탄탄각선미'	bnt뉴스
[사진]하주희, '건강미 넘치는 발걸음'	OSEN
씨스타 보라, 오키나와 화보…건강미 '물씬'	머니투데이
[사진]치어리더,'건강미'	OSEN
[공식입장]노홍철부터 미쓰라 부부까지" '공복자들' 7인 출연진 확정	뉴스1
[포토] 3대3 농구 '치어리더의 건강미 발산'	스포츠조선
바다, 빛나는 구리빛 건강미 [MK포토]	MK스포츠
<포토>‘2014 miss sexy back’ 건강미 넘치는 뒤태!	헤럴드경제
하용수, "김혜수 건강미 넘쳐…섹시 콘셉트 제안"	머니투데이
[사진]장여진,'건강미 넘치는 자태'(2019 머슬마니아)	OSEN
[bnt포토] 미쓰에이 민 '건강미 넘치는 탄탄각선미'	bnt뉴스
[사진]하주희, '건강미 넘치는 발걸음'	OSEN
씨스타 보라, 오키나와 화보…건강미 '물씬'	머니투데이
[사진]치어리더,'건강미'	OSEN
[공식입장]노홍철부터 미쓰라 부부까지" '공복자들' 7인 출연진 확정	뉴스1
[포토] 3대3 농구 '치어리더의 건강미 발산'	스포츠조선
바다, 빛나는 구리빛 건강미 [MK포토]	MK스포츠
<포토>‘2014 miss sexy back’ 건강미 넘치는 뒤태!	헤럴드경제
하용수, "김혜수 건강미 넘쳐…섹시 콘셉트 제안"	머니투데이
[사진]장여진,'건강미 넘치는 자태'(2019 머슬마니아)	OSEN
[bnt포토] 미쓰에이 민 '건강미 넘치는 탄탄각선미'	bnt뉴스
[사진]하주희, '건강미 넘치는 발걸음'	OSEN
씨스타 보라, 오키나와 화보…건강미 '물씬'	머니투데이
[사진]치어리더,'건강미'	OSEN
[공식입장]노홍철부터 미쓰라 부부까지" '공복자들' 7인 출연진 확정	뉴스1
[포토] 3대3 농구 '치어리더의 건강미 발산'	스포츠조선
바다, 빛나는 구리빛 건강미 [MK포토]	MK스포츠
<포토>‘2014 miss sexy back’ 건강미 넘치는 뒤태!	헤럴드경제
하용수, "김혜수 건강미 넘쳐…섹시 콘셉트 제안"	머니투데이
[사진]장여진,'건강미 넘치는 자태'(2019 머슬마니아)	OSEN
[bnt포토] 미쓰에이 민 '건강미 넘치는 탄탄각선미'	bnt뉴스
[사진]하주희, '건강미 넘치는 발걸음'	OSEN
씨스타 보라, 오키나와 화보…건강미 '물씬'	머니투데이
[사진]치어리더,'건강미'	OSEN
[공식입장]노홍철부터 미쓰라 부부까지" '공복자들' 7인 출연진 확정	뉴스1
[포토] 3대3 농구 '치어리더의 건강미 발산'	스포츠조선
바다, 빛나는 구리빛 건강미 [MK포토]	MK스포츠
<포토>‘2014 miss sexy back’ 건강미 넘치는 뒤태!	헤럴드경제
하용수, "김혜수 건강미 넘쳐…섹시 콘셉트 제안"	머니투데이
[사진]장여진,'건강미 넘치는 자태'(2019 머슬마니아)	OSEN
[bnt포토] 미쓰에이 민 '건강미 넘치는 탄탄각선미'	bnt뉴스
[사진]하주희, '건강미 넘치는 발걸음'	OSEN
씨스타 보라, 오키나와 화보…건강미 '물씬'	머니투데이
[사진]치어리더,'건강미'	OSEN
[공식입장]노홍철부터 미쓰라 부부까지" '공복자들' 7인 출연진 확정	뉴스1
[포토] 3대3 농구 '치어리더의 건강미 발산'	스포츠조선
바다, 빛나는 구리빛 건강미 [MK포토]	MK스포츠
<포토>‘2014 miss sexy back’ 건강미 넘치는 뒤태!	헤럴드경제
하용수, "김혜수 건강미 넘쳐…섹시 콘셉트 제안"	머니투데이
[사진]장여진,'건강미 넘치는 자태'(2019 머슬마니아)	OSEN
[bnt포토] 미쓰에이 민 '건강미 넘치는 탄탄각선미'	bnt뉴스
[사진]하주희, '건강미 넘치는 발걸음'	OSEN
씨스타 보라, 오키나와 화보…건강미 '물씬'	머니투데이
[사진]치어리더,'건강미'	OSEN
[공식입장]노홍철부터 미쓰라 부부까지" '공복자들' 7인 출연진 확정	뉴스1
[포토] 3대3 농구 '치어리더의 건강미 발산'	스포츠조선
바다, 빛나는 구리빛 건강미 [MK포토]	MK스포츠
<포토>‘2014 miss sexy back’ 건강미 넘치는 뒤태!	헤럴드경제
하용수, "김혜수 건강미 넘쳐…섹시 콘셉트 제안"	머니투데이
[사진]장여진,'건강미 넘치는 자태'(2019 머슬마니아)	OSEN
[bnt포토] 미쓰에이 민 '건강미 넘치는 탄탄각선미'	bnt뉴스
[사진]하주희, '건강미 넘치는 발걸음'	OSEN
씨스타 보라, 오키나와 화보…건강미 '물씬'	머니투데이
[사진]치어리더,'건강미'	OSEN
[공식입장]노홍철부터 미쓰라 부부까지" '공복자들' 7인 출연진 확정	뉴스1
[포토] 3대3 농구 '치어리더의 건강미 발산'	스포츠조선
바다, 빛나는 구리빛 건강미 [MK포토]	MK스포츠
<포토>‘2014 miss sexy back’ 건강미 넘치는 뒤태!	헤럴드경제
하용수, "김혜수 건강미 넘쳐…섹시 콘셉트 제안"	머니투데이
[사진]장여진,'건강미 넘치는 자태'(2019 머슬마니아)	OSEN
[bnt포토] 미쓰에이 민 '건강미 넘치는 탄탄각선미'	bnt뉴스
[사진]하주희, '건강미 넘치는 발걸음'	OSEN
씨스타 보라, 오키나와 화보…건강미 '물씬'	머니투데이
[사진]치어리더,'건강미'	OSEN
[공식입장]노홍철부터 미쓰라 부부까지" '공복자들' 7인 출연진 확정	뉴스1
[포토] 3대3 농구 '치어리더의 건강미 발산'	스포츠조선
바다, 빛나는 구리빛 건강미 [MK포토]	MK스포츠
<포토>‘2014 miss sexy back’ 건강미 넘치는 뒤태!	헤럴드경제
하용수, "김혜수 건강미 넘쳐…섹시 콘셉트 제안"	머니투데이
[사진]장여진,'건강미 넘치는 자태'(2019 머슬마니아)	OSEN
[bnt포토] 미쓰에이 민 '건강미 넘치는 탄탄각선미'	bnt뉴스
[사진]하주희, '건강미 넘치는 발걸음'	OSEN
씨스타 보라, 오키나와 화보…건강미 '물씬'	머니투데이
[사진]치어리더,'건강미'	OSEN
[공식입장]노홍철부터 미쓰라 부부까지" '공복자들' 7인 출연진 확정	뉴스1
[포토] 3대3 농구 '치어리더의 건강미 발산'	스포츠조선
바다, 빛나는 구리빛 건강미 [MK포토]	MK스포츠
<포토>‘2014 miss sexy back’ 건강미 넘치는 뒤태!	헤럴드경제
하용수, "김혜수 건강미 넘쳐…섹시 콘셉트 제안"	머니투데이
[사진]장여진,'건강미 넘치는 자태'(2019 머슬마니아)	OSEN
[bnt포토] 미쓰에이 민 '건강미 넘치는 탄탄각선미'	bnt뉴스
[사진]하주희, '건강미 넘치는 발걸음'	OSEN
씨스타 보라, 오키나와 화보…건강미 '물씬'	머니투데이
