40
마마무 화사, 밀착 브라톱+레깅스…독보적인 건강미	머니투데이
80g 때 버려져 얼마 못 산다던 아깽이에 집사 생기자..'건강미 뿜뿜'	노트펫
"건강미란 이런 것"...김혜연, 건강미 넘치는 화보 공개	뉴스타운
[MHN포토] 마마무 '넘치는 건강미'	문화뉴스
[포토] 화사, '건강미의 표본'	한국경제
[포토] 솔라 '구릿빛 건강미'	일간스포츠
가희, 등산하며 꾸준한 자기관리..건강미 넘치는 미소[★SHOT!]	OSEN
마마무 화사 '건강미 넘치는 레깅스 핏'[엑's HD화보]	엑스포츠뉴스
[포토] 솔라, 건강미 뽐내는 패션	뉴데일리
[포토] 츄, 건강미 넘치는 비율	매일경제
[포토] 화사, '건강미의 표본'	한국경제
[포토] 마마무, 컴백 앞두고 건강미로 예열	시사포커스
[포토] 화사, '건강미 넘치는 그녀~'	한국경제
김혜수, 섹시 건강미의 대명사…마스크 써도 우아함 철철	헤럴드POP
[사진]마마무 화사,'건강미 돋보이는 라인'	OSEN
화사 (마마무) ‘탄탄 몸매에 넘치는 건강미’ [포토엔HD]	뉴스엔
[사진]마마무 화사,'건강미로 완성한 레깅스 핏'	OSEN
비키니 피트니스 (전문), 건강미 넘치는 선수들 무대스케치 (SBS Mr. & Ms Ko...	시민의소리
김혜수, 건강미 넘치는 일상 '시선강탈'	한국일보
김성령, 건강미 넘치는 프리다이빙…"54세 몸매 맞아?"	머니투데이
마이23헬스케어, ‘환불 챌린지프로그램’ 진행	로이슈
오또맘, 건강미 넘치는 모습 '부러워'	뉴스컬처
이하늬, 크롭트 톱 입고 복근 공개…숨길 수 없는 건강미	머니투데이
치어리더 차영현 `건강미 가득` [MK포토]	MK스포츠
김희정, 시선 강탈 구릿빛 섹시..건강미에 감탄	헤럴드POP
[포토] K타이거즈 제로, 건강미 넘치는 퍼포먼스	일간스포츠
'이욱♥'벤, 필라테스 후 건강미 업그레이드..민낯 미모까지 완벽	헤럴드POP
류시원, 재혼 후 근황…49세 나이 믿기지 않는 동안+건강미	한국경제
'눈에 띄는 근육'…치어리더, 남다른 건강미 자랑 [MD화보]	마이데일리
'48.6kg' 김지우, ♥레이먼킴도 놀랄 건강미 가득 보디라인	MBN
‘건강미 대명사’ 최여진, 보트 위 구릿빛 여신 [SNS★컷]	뉴스엔
류화영, 건강미 돋보이는 테니스장에서의 하루	뉴스컬처
‘연애혁명’ 우주소녀 다영, 건강미+걸크러시 가득…스틸컷 공개 [MK★TV컷]	MK스포츠
"지금의 내가 좋다"...안선영, 40대 건강미 빛나는 화보 B컷 대방출	YTN
유이, 피트니스 콘텐츠 구독자 수 10만 돌파..건강미 넘치는 행보	헤럴드POP
[포토] 유현주 '핫함을 더한 건강미'	이데일리
[오마이포토] 'SF9' 재윤, 단단한 건강미	오마이뉴스
매일유업, 박세리‘셀렉스’ CF 촬영 현장서 건강미 발산	조세일보
"168cm·55kg"…안선영, 건강미 넘치는 보디라인 "40대의 미학" [종합]	텐아시아
신현빈, 건강미X고혹미 다 가진 매력부자 '심쿵주의보' [화보]	TV리포트
