'바람피면' 조여정, 범죄 소설가 변신..'다크 아우라'	스타뉴스
[DAY컷] ‘바람피면 죽는다’ 조여정 치명美, 12월 2일 첫방	스포츠동아
조여정, 16일 부친상 "가족장으로 조용히 치를 것"	YTN
'바람피면 죽는다' 조여정X고준, 대본리딩 현장 공개 '엄지 척'	텐아시아
조여정, 발레복도 완벽 소화...우아한 백조 자태	매일경제
조여정-고준, '바람피면 죽는다' 12월 2일 첫방 확정	일간스포츠
[공식] 조여정X고준 '바람피면 죽는다' 12월 2일 첫 방송 확정	스포츠조선
‘바람피면 죽는다’ 조여정 “튀긴 아이스크림 같은 드라마”	뉴스엔
`바람피면 죽는다` 조여정X고준, 대본리딩 메이킹 영상+미공개 스틸 공개	매일경제
조여정X고준 ‘바람피면 죽는다’, 킬링 케미 예고…1차 포스터 공개	스포츠동아
조여정X고준 ‘바람피면 죽는다’ 12월2일 첫방송 확정(공식입장)	뉴스엔
조여정X고준 '바람피면 죽는다', 12월 2일 첫 방송 확정 [공식]	마이데일리
조여정 "'바람피면 죽는다', 튀긴 아이스크림 같은 드라마"…장르 맛집 예고	디지틀조선일보
'바람피면 죽는다' 조여정 "튀긴 아이스크림 같은 드라마"···차별화된 반전	서울경제
'공주가 따로 없네' 조여정, 발레리나 변신 드라마 비하인드 공개[★SNS]	스포츠서울
'바람피면 죽는다' 조여정X고준, 핏빛 '신체 포기 각서' 공개..'킬링 드라마'...	OSEN
조여정, 몸매 드러낸 발레복도 찰떡 소화..너무 사랑스러운 오스카 스타	헤럴드POP
'바람피면 죽는다' 조여정-고준, 1차 티저 포스터 속 '각서' 날짜는 첫 방송 ...	한국일보
'바람피면 죽는다' 조여정X고준, 부부로 '킬링 케미'···12월 2일 첫 방송	서울경제
'바람피면 죽는다' 메이킹 영상 X 스틸 공개…조여정 "튀긴 아이스크림 같은 ...	스포츠서울
[TF포토] 우아하게 입장하는 조여정	더팩트
[TF포토] 조여정, 아침에도 빛나는 피부	더팩트
엔캣 남대문-해외바이어 액세서리 플랫폼 출범...모델 조여정	파이낸셜뉴스
조여정, 안방극장 돌아오는 변신의 귀재	뉴스엔
'바람피면 죽는다' 조여정X고준, 대본리딩 메이킹 영상·스틸 공개...장르 맛...	싱글리스트
[TF사진관] 조여정, '피로 날리는 꿀미소~'	더팩트
[TF포토] 조여정, 전기차 'E-텐스'와 함께~	더팩트
[공식]조여정 ‘바람피면 죽는다’ 안방 컴백..이번엔 베스트셀러 작가 대변신	스포츠조선
조여정, 집 앞 바캉스 룩…가냘픈 팔뚝 '깜짝'	머니투데이
조여정, 가냘픈 팔뚝+어깨라인 노출 "집 앞 나가는데 바캉스룩"	스포츠조선
[포토] 조여정 '단아와 정갈의 대명사'	일간스포츠
[포토] 조여정 '검정나비 총총총'	일간스포츠
[포토] 조여정 '변함없는 미모'	일간스포츠
[포토] 조여정 '간만에 날려드리리'	일간스포츠
[포토] 조여정 '정갈한 올블랙'	일간스포츠
[포토] 조여정 '이게 대체 얼마만'	일간스포츠
[포토] 조여정 '환경을 소중해요'	일간스포츠
조여정, '바람피면 죽는다'로 안방 컴백…변신의 귀재 활약 '기대 UP'	엑스포츠뉴스
조여정, 변신의 귀재다운 놀라운 행보…차기작 '바람피면 죽는다' 기대	헤럴드POP
조여정, 민낯에도 빛나는 청순미..."집 앞 나가는데 바캉스룩"	매일경제
[포토] 조여정 '기생충 투어 후 푹 쉬었어요'	일간스포츠
[포토] 조여정 '우리 같이 지구를 지켜요'	일간스포츠
‘못된고양이’ 해외 비즈니스 플랫폼 선보인다...모델로 조여정 발탁	세계일보
조여정최시원·로운 K-FOOD 수출도우미로 활약	보건뉴스
[E포토] 조여정, '여신이 따로 없네'	SBS funE
[E포토] 조여정, '빛나는 하트'	SBS funE
[E포토] 조여정, '단아한 자태'	SBS funE
[E포토] 조여정, '빛나는 미모'	SBS funE
조여정, 올해 40세 맞아? 시선 사로잡는 청순+동안 미모 ‘감탄’ [SNS★컷]	뉴스엔
조여정, 민낯에도 무결점 미모 "놀러 가고 싶어서 바캉스룩"	마이데일리
[포토]조여정, '지구를 살리는 전기차'	이데일리
조여정, 명품 피부+맑은 눈망울…클로즈업 부르는 '동안 미모' 정석	스포츠조선
조여정 '우아하게'[엑's HD포토]	엑스포츠뉴스
[포토] 조여정, 전기차 모델입니다~	스포츠서울
[포토] 조여정, 전기차 모델로 찰칵~!	스포츠서울
[bnt포토] 조여정 '단아한 자태'	bnt뉴스
[bnt포토] 조여정 '미소에 반하다'	bnt뉴스
[bnt포토] 조여정 '산뜻한 손인사'	bnt뉴스
[bnt포토] 조여정 '지구를 부탁해'	bnt뉴스
[포토] 조여정, 우아한 자태	디지털타임스
조여정 '우아한 블랙 스완'[엑's HD포토]	엑스포츠뉴스
조여정 '손하트는 기본이죠'[엑's HD포토]	엑스포츠뉴스
[ER 포토] 조여정도 반한 'DS 3 크로스백 E-텐스'	이코노믹리뷰
[bnt포토] 조여정 '빠져드는 보조개 미소'	bnt뉴스
[bnt포토] 조여정 '변함없는 동안 비주얼'	bnt뉴스
[bnt포토] 조여정 '등장만으로 시선 강탈'	bnt뉴스
[SW포토]빛나는 조여정	스포츠월드
조여정, 집앞 외출에도 바캉스룩 차려입은 귀여운 40세…'민낯 여신'	스포티비뉴스
40살 맞아?…조여정, 앞머리 내리고 '동안美' 장착	텐아시아
조여정, 인형이야? 흔들려도 완벽한 옆선	매일경제
조여정, 막 찍어도 빛나네..초동안 미녀의 4분할 셀카	헤럴드POP
조여정 '우아함 끝판왕'[★포토]	스타뉴스
조여정-고준, KBS 2TV '바람피면 죽는다' 주연 확정…10월 첫방[공식]	일간스포츠
[사진]조여정,'토끼눈 인사'	OSEN
[사진]조여정,'계시나요?'	OSEN
[사진]조여정,'반짝반짝'	OSEN
[사진]조여정,'우아한 턴'	OSEN
[사진]조여정,'귀엽고 깜찍하게'	OSEN
[사진]조여정,'반짝이는 눈맞춤'	OSEN
[사진]조여정,'별보다 반짝여'	OSEN
[사진]조여정,'깨끗한 미소'	OSEN
[사진]조여정,'눈부신 우아함'	OSEN
조여정X고준 '바람피면 죽는다', 첫 대본리딩 현장 공개···시너지 폭발	일간스포츠
조여정, 어깨라인+청초한 민낯 “집앞 나가는데 바캉스룩”	스포츠동아
조여정X고준, '바람피면 죽는다' 주연 캐스팅 확정…10월 첫 방송 예정	한국경제
[포토] 조여정, '품위있는 그녀'	한국경제
[포토] 조여정, '이러니 반할 수 밖에~'	한국경제
‘못된고양이’ 엔캣, 해외 비즈니스 플랫폼 선봬...조여정 모델 발탁	쿠키뉴스
조여정, 쑥대머리 "10:0가르마 언젠가는"→옥주현·이진 "하아..말려봐봐"[★...	OSEN
[MD포토] 조여정 '지구를 생각하는 마음으로'	마이데일리
조여정X고준, '바람피면 죽는다' 주연 확정…부부 케미 기대 [공식]	텐아시아
[포토] 조여정, '올 블랙 시크한 그녀'	한국경제
[포토] 조여정, '수많은 취재진에 깜짝!'	한국경제
[포토] 조여정, '할리우드 분위기 물씬~'	한국경제
[포토] 조여정, '사랑스러운 K하트'	한국경제
조여정, 앞머리 자르고 '확' 어려진 미모…청순미 '폭발'	머니투데이
[톱포토] 조여정, 점점 더 예뻐지네	톱데일리
조여정 주연 드라마 ‘아름다운 세상’ 일본 BS서 방송된다	스포츠경향
[SW포토]예쁜 손하트 발사하는 조여정	스포츠월드
[SW포토]배우 조여정의 빛나는 손인사	스포츠월드
'바람피면 죽는다' 조여정X고준, 신체 포기각서 쓴 이유?…12월 2일 첫방송	스포츠서울
'바람피면 죽는다' 조여정 "튀긴 아이스크림 같은 드라마"	엑스포츠뉴스
'공주가 따로 없네' 조여정, 발레리나 변신 드라마 비하인드 공개[★SNS]	스포츠서울
조여정, 몸매 드러낸 발레복도 찰떡 소화..너무 사랑스러운 오스카 스타	헤럴드POP
'바람피면 죽는다' 메이킹 영상 X 스틸 공개…조여정 "튀긴 아이스크림 같은 ...	스포츠서울
차희, 조여정X고준 주연 '바람피면 죽는다' 합류…연우 비서 役으로 활약!	헤럴드POP
조여정, 현장을 환하게 밝히는 햇살 같은 눈부신 미소!	뉴스타운
조여정, 차기작 ‘바람피면 죽는다’ 기대 UP	스포츠동아
조여정 부친상, "가족장으로 조용히"	아시아뉴스통신
'기생충' 주연 조여정 덕분에 호주에 김치 수출	서울파이낸스
'바람피면 죽는다' 조여정X고준, 핏빛 '신체 포기 각서' 공개..'킬링 드라마'...	OSEN
조여정, 몸매 드러낸 발레복도 찰떡 소화..너무 사랑스러운 오스카 스타	헤럴드POP
'바람피면 죽는다' 메이킹 영상 X 스틸 공개…조여정 "튀긴 아이스크림 같은 ...	스포츠서울
조여정X고준 ‘바람피면 죽는다’, 대본리딩 메이킹 영상-스틸..장르 맛집	브레이크뉴스
차희, 조여정X고준 주연 '바람피면 죽는다' 합류…연우 비서 役으로 활약!	헤럴드POP
조여정, 현장을 환하게 밝히는 햇살 같은 눈부신 미소!	뉴스타운
조여정, 차기작 ‘바람피면 죽는다’ 기대 UP	스포츠동아
조여정 부친상, "가족장으로 조용히"	아시아뉴스통신
'기생충' 주연 조여정 덕분에 호주에 김치 수출	서울파이낸스
조여정‧최시원·로운 덕에 K-푸드 수출도 '껑충'	파이낸셜뉴스
‘바람피면 죽는다’ 1차 티저 포스터 공개	광주매일신문
'바람피면 죽는다' 조여정 "튀긴 아이스크림 같은 강렬하고 압도적인 드라마"	한강타임즈
조여정, 발레복 입고 탄탄한 몸매 자랑 '러블리 미소' [데일리SHOT]	마이데일리
'활동명 변경' 차희, 조여정x고준 '바람피면 죽는다' 합류...연우 비서 役	엑스포츠뉴스
조여정, 현장을 환하게 밝히는 햇살 같은 눈부신 미소!	뉴스타운
조여정, 차기작 ‘바람피면 죽는다’ 기대 UP	스포츠동아
조여정 부친상, "가족장으로 조용히"	아시아뉴스통신
'기생충' 주연 조여정 덕분에 호주에 김치 수출	서울파이낸스
조여정‧최시원·로운 덕에 K-푸드 수출도 '껑충'	파이낸셜뉴스
조여정 "집앞가는데 바캉스룩"..집콕일상 속 매력발산	일간스포츠
조여정, 월드스타의 클래스가 다른 햇살 미모	뉴스엔
12월 2일 첫 방송 '바람피면 죽는다' 대본리딩 메이킹 영상 X 미공개 스틸 공...	스타데일리뉴스
조여정, 차기작 ‘바람피면 죽는다’ 기대 UP	스포츠동아
조여정 부친상, "가족장으로 조용히"	아시아뉴스통신
'기생충' 주연 조여정 덕분에 호주에 김치 수출	서울파이낸스
조여정‧최시원·로운 덕에 K-푸드 수출도 '껑충'	파이낸셜뉴스
조여정 "집앞가는데 바캉스룩"..집콕일상 속 매력발산	일간스포츠
[TF포토] 우아하게 입장하는 조여정	더팩트
엔캣 남대문-해외바이어 액세서리 플랫폼 출범...모델 조여정	파이낸셜뉴스
[포토] 조여정, '친환경 깃발을 콕!'	아주경제
[TF포토] 우아하게 입장하는 조여정	더팩트
엔캣 남대문-해외바이어 액세서리 플랫폼 출범...모델 조여정	파이낸셜뉴스
조여정, 안방극장 돌아오는 변신의 귀재	뉴스엔
'바람피면 죽는다' 조여정X고준, 대본리딩 메이킹 영상·스틸 공개...장르 맛...	싱글리스트
조여정, 집 앞 바캉스 룩…가냘픈 팔뚝 '깜짝'	머니투데이
[포토] 조여정, '친환경 깃발을 콕!'	아주경제
aT, 조여정?최시원·로운 덕분에 K-FOOD 수출도 '껑충'	전남일보
[포토] 조여정 '반가워요'	일간스포츠
[포토] 조여정, '우아한 손인사'	아주경제
[HS포토] 조여정, E-텐스 더욱 빛내는 미모	한스경제
